SolutionID,TotalCost,NumNodes,TotalDistance,ObjectiveFunction,Cycle
1,72834,100,24621,97455,"194-180-133-151-162-149-131-65-116-43-184-84-112-190-10-177-54-48-160-34-146-22-18-108-69-159-181-42-5-41-193-139-68-46-115-59-118-51-0-117-143-183-89-186-23-137-176-80-79-63-94-124-152-97-1-101-2-120-129-55-49-102-148-9-62-144-14-178-106-165-90-81-196-40-119-185-52-57-92-179-145-78-31-56-113-175-171-16-25-44-75-86-26-100-53-154-135-70-127-123"
2,72584,100,24340,96924,"20-22-146-159-41-193-5-42-181-34-160-48-54-177-10-190-112-84-184-43-116-65-131-149-123-127-162-151-133-135-70-180-154-53-100-26-86-75-44-25-16-171-175-113-56-31-78-145-179-92-57-52-185-119-40-196-81-90-165-106-178-14-144-62-9-148-102-49-55-129-120-2-101-1-97-152-124-94-63-79-80-176-137-23-186-89-183-143-117-0-51-59-118-115-46-68-139-69-108-18"
3,72602,100,23435,96037,"94-152-97-1-101-2-120-129-57-92-179-145-78-31-56-113-175-171-16-25-44-75-86-26-100-53-154-70-135-180-63-79-133-51-118-59-115-46-68-139-193-41-5-42-181-159-69-108-18-22-146-34-160-48-54-177-10-190-4-112-84-35-184-43-116-65-131-149-123-127-162-151-80-176-137-23-183-89-186-15-9-62-144-14-138-165-90-81-196-40-119-185-55-52-106-178-49-102-148-124"
4,72835,100,24148,96983,"182-121-100-26-86-75-44-25-16-171-175-113-56-31-78-145-179-92-57-52-185-119-40-196-81-90-165-106-178-14-144-62-9-148-102-49-55-129-120-2-101-1-97-152-124-94-63-79-80-176-137-23-186-89-183-143-117-0-51-118-59-115-46-68-139-193-41-5-42-181-159-69-108-18-22-146-34-160-48-54-177-10-190-84-184-43-116-65-131-149-123-127-162-151-133-180-135-70-154-53"
5,73194,100,23503,96697,"19-152-1-101-100-26-97-2-120-129-57-92-179-145-78-31-56-113-175-171-16-25-44-75-86-53-154-70-135-180-63-79-133-51-118-59-115-46-68-139-193-41-5-42-181-159-69-108-18-22-146-34-160-48-54-177-10-190-4-112-84-184-43-116-65-131-149-123-127-162-151-80-176-137-23-183-89-186-15-9-62-144-14-138-165-90-81-196-40-119-185-55-52-106-178-49-102-148-124-94"
6,72276,100,23766,96042,"156-127-123-162-151-133-135-70-180-154-53-100-26-86-75-44-25-16-171-175-113-56-31-78-145-179-92-57-52-185-119-40-196-81-90-165-106-178-14-144-62-9-148-102-49-55-129-120-2-101-1-97-152-124-94-63-79-80-176-137-23-186-89-183-143-117-0-51-118-59-65-116-43-42-5-115-46-68-139-41-193-159-69-108-18-22-146-181-34-160-48-54-177-10-190-184-35-84-4-112"
7,72081,100,24305,96386,"115-118-59-51-0-117-143-183-89-186-23-137-176-80-79-63-94-124-152-97-1-101-2-120-129-55-49-102-148-9-62-144-14-178-106-165-90-81-196-40-119-185-52-57-92-179-145-78-31-56-113-175-171-16-25-44-75-86-26-100-53-154-180-70-135-133-151-162-127-123-149-131-65-116-43-184-84-112-4-190-10-177-54-48-160-34-146-22-18-108-69-159-181-42-5-41-193-139-68-46"
8,71719,100,24005,95724,"140-117-143-183-89-186-23-137-176-80-79-63-94-124-152-97-1-101-2-120-129-55-49-102-148-9-62-144-14-178-106-165-90-81-196-40-119-185-52-57-92-179-145-78-31-56-113-175-171-16-25-44-75-86-26-100-53-154-180-135-70-127-123-162-133-151-51-118-59-65-116-43-184-84-112-4-190-10-177-54-48-160-34-146-22-18-108-69-159-181-42-5-115-41-193-139-68-46-0-93"
9,72276,100,23766,96042,"156-127-123-162-151-133-135-70-180-154-53-100-26-86-75-44-25-16-171-175-113-56-31-78-145-179-92-57-52-185-119-40-196-81-90-165-106-178-14-144-62-9-148-102-49-55-129-120-2-101-1-97-152-124-94-63-79-80-176-137-23-186-89-183-143-117-0-51-118-59-65-116-43-42-5-115-46-68-139-41-193-159-69-108-18-22-146-181-34-160-48-54-177-10-190-184-35-84-4-112"
10,72980,100,24302,97282,"21-144-62-9-148-102-49-178-106-52-55-57-92-129-152-97-1-101-100-53-180-154-135-70-127-123-162-149-131-65-116-43-184-35-84-112-4-190-10-177-30-54-48-160-34-146-22-18-108-69-159-181-42-5-41-193-139-68-46-115-59-118-51-151-133-176-143-183-89-23-137-80-79-63-94-26-86-75-2-120-44-25-16-171-175-113-56-31-78-145-179-185-119-40-196-81-90-165-138-14"
11,72639,100,24161,96800,"2-75-86-26-94-63-79-80-137-23-89-183-143-0-176-133-151-51-118-59-115-46-68-139-193-41-5-42-181-159-69-108-18-22-146-34-160-48-54-30-177-10-190-4-112-84-35-184-43-116-65-131-149-162-123-127-70-135-154-180-53-100-101-1-97-152-129-55-49-102-148-9-62-144-14-3-178-106-165-90-81-196-40-119-185-52-57-92-179-145-78-31-56-113-175-171-16-25-44-120"
12,73307,100,24957,98264,"104-54-48-34-160-181-42-43-116-41-193-159-146-22-18-108-69-139-68-46-115-118-59-65-131-149-151-51-0-117-143-183-89-186-23-137-176-80-79-63-94-124-152-97-1-101-2-120-129-55-49-102-148-9-62-144-14-178-106-165-90-81-196-40-119-185-52-57-92-179-145-78-31-56-113-175-171-16-25-44-75-86-26-100-53-154-180-70-135-133-162-123-127-112-4-84-184-190-10-177"
13,72507,100,24123,96630,"192-181-146-22-18-108-69-159-193-41-139-68-46-115-118-59-51-0-117-143-183-89-186-23-137-176-80-79-63-94-124-152-97-1-101-2-120-129-55-49-102-148-9-62-144-14-178-106-165-90-81-196-40-119-185-52-57-92-179-145-78-31-56-113-175-171-16-25-44-75-86-26-100-53-154-180-70-135-133-151-162-127-123-149-131-65-116-43-42-184-84-112-4-190-10-177-54-48-160-34"
14,73061,100,24329,97390,"6-154-53-100-26-86-75-44-25-16-171-175-113-56-31-78-145-179-92-57-52-185-119-40-196-81-90-165-106-178-14-144-62-9-148-102-49-55-129-120-2-101-1-97-152-124-94-63-79-80-176-137-23-186-89-183-143-117-0-51-118-59-115-46-68-139-193-41-5-42-181-159-69-108-18-22-146-34-160-48-54-177-10-190-112-84-184-43-116-65-131-149-123-127-162-151-133-180-70-135"
15,73649,100,23166,96815,"17-196-81-90-40-119-165-185-106-178-3-14-144-62-9-148-102-49-52-55-57-179-145-78-92-129-152-97-1-101-100-53-180-154-135-70-127-123-162-149-131-65-116-43-184-35-84-112-4-190-10-177-30-54-48-160-34-146-22-18-108-69-159-181-42-5-41-193-139-68-46-115-59-118-51-151-133-176-183-89-23-137-80-79-63-94-26-86-75-2-120-44-25-16-171-175-113-56-31-157"
16,72530,100,23893,96423,"36-108-69-18-22-146-159-193-41-5-42-181-34-160-48-54-177-10-190-184-43-116-65-131-149-123-127-162-151-133-135-70-180-154-53-100-26-86-75-44-25-16-171-175-113-56-31-78-145-179-92-57-52-185-119-40-196-81-90-165-106-178-14-144-62-9-148-102-49-55-129-120-2-101-1-97-152-124-94-63-79-80-176-137-23-186-89-183-143-117-0-51-59-118-115-46-139-68-93-140"
17,72081,100,24305,96386,"193-139-68-46-115-118-59-51-0-117-143-183-89-186-23-137-176-80-79-63-94-124-152-97-1-101-2-120-129-55-49-102-148-9-62-144-14-178-106-165-90-81-196-40-119-185-52-57-92-179-145-78-31-56-113-175-171-16-25-44-75-86-26-100-53-154-180-70-135-133-151-162-127-123-149-131-65-116-43-184-84-112-4-190-10-177-54-48-160-34-146-22-18-108-69-159-181-42-5-41"
18,71488,100,23578,95066,"143-183-89-186-23-137-176-80-79-63-94-124-152-97-1-101-2-120-129-55-49-102-148-9-62-144-14-178-106-165-90-81-196-40-119-185-52-57-92-179-145-78-31-56-113-175-171-16-25-44-75-86-26-100-53-154-180-135-70-127-123-162-133-151-51-118-59-65-116-43-184-35-84-112-4-190-10-177-30-54-48-160-34-146-22-18-108-69-159-181-42-5-115-41-193-139-68-46-0-117"
19,71926,100,24150,96076,"108-69-139-68-46-115-118-59-51-0-117-143-183-89-186-23-137-176-80-79-63-94-124-152-97-1-101-2-120-129-55-49-102-148-9-62-144-14-178-106-165-90-81-196-40-119-185-52-57-92-179-145-78-31-56-113-175-171-16-25-44-75-86-26-100-53-154-180-70-135-133-151-162-127-123-149-131-65-116-43-184-84-112-4-190-10-177-54-48-160-34-181-42-5-41-193-159-146-22-18"
20,72265,100,23749,96014,"126-127-123-162-151-133-135-70-180-154-53-100-26-86-75-44-25-16-171-175-113-56-31-78-145-179-92-57-52-185-119-40-196-81-90-165-106-178-14-144-62-9-148-102-49-55-129-120-2-101-1-97-152-124-94-63-79-80-176-137-23-186-89-183-143-117-0-51-118-59-65-116-43-42-5-115-46-68-139-41-193-159-69-108-18-22-146-181-34-160-48-54-177-10-190-184-35-84-4-112"
21,72265,100,23749,96014,"126-127-123-162-151-133-135-70-180-154-53-100-26-86-75-44-25-16-171-175-113-56-31-78-145-179-92-57-52-185-119-40-196-81-90-165-106-178-14-144-62-9-148-102-49-55-129-120-2-101-1-97-152-124-94-63-79-80-176-137-23-186-89-183-143-117-0-51-118-59-65-116-43-42-5-115-46-68-139-41-193-159-69-108-18-22-146-181-34-160-48-54-177-10-190-184-35-84-4-112"
22,73043,100,24566,97609,"66-0-117-143-183-89-186-23-137-80-79-63-94-124-152-97-1-101-2-120-129-55-49-102-148-9-62-144-14-178-106-165-90-81-196-40-119-185-52-57-92-179-145-78-31-56-113-175-171-16-25-44-75-86-26-100-53-154-180-135-70-127-123-162-133-151-149-131-65-116-43-184-84-112-190-10-177-54-48-160-34-146-22-18-108-69-159-181-42-5-41-193-139-68-46-115-59-118-51-176"
23,72129,100,24353,96482,"68-46-115-118-59-51-0-117-143-183-89-186-23-137-176-80-79-63-94-124-152-97-1-101-2-120-129-55-49-102-148-9-62-144-14-178-106-165-90-81-196-40-119-185-52-57-92-179-145-78-31-56-113-175-171-16-25-44-75-86-26-100-53-154-180-70-135-133-151-162-127-123-149-131-65-116-43-184-84-112-4-190-10-177-54-48-160-34-146-22-18-108-69-159-181-42-5-193-41-139"
24,72985,100,24475,97460,"197-116-65-59-118-51-0-117-143-183-89-186-23-137-176-80-79-63-94-124-152-97-1-101-2-120-129-55-49-102-148-9-62-144-14-178-106-165-90-81-196-40-119-185-52-57-92-179-145-78-31-56-113-175-171-16-25-44-75-86-26-100-53-154-180-70-135-133-151-162-127-123-149-131-43-184-84-112-190-10-177-54-48-160-34-146-22-18-108-69-159-181-42-5-41-193-139-68-46-115"
25,73061,100,24329,97390,"6-154-53-100-26-86-75-44-25-16-171-175-113-56-31-78-145-179-92-57-52-185-119-40-196-81-90-165-106-178-14-144-62-9-148-102-49-55-129-120-2-101-1-97-152-124-94-63-79-80-176-137-23-186-89-183-143-117-0-51-118-59-115-46-68-139-193-41-5-42-181-159-69-108-18-22-146-34-160-48-54-177-10-190-112-84-184-43-116-65-131-149-123-127-162-151-133-180-70-135"
26,73539,100,22759,96298,"71-164-7-95-39-165-138-14-144-62-9-148-102-49-178-106-52-55-57-92-129-152-97-1-101-100-53-180-154-135-70-127-123-162-149-131-65-116-43-184-35-84-112-4-190-10-177-54-48-160-34-146-22-18-108-69-159-181-42-5-41-193-139-68-46-115-59-118-51-151-133-176-137-80-79-63-94-26-86-75-2-120-44-25-16-171-175-113-56-31-78-145-179-185-119-40-196-81-90-27"
27,72920,100,24748,97668,"28-43-65-131-149-123-127-162-151-133-135-70-180-154-53-100-26-86-75-44-25-16-171-175-113-56-31-78-145-179-92-57-52-185-119-40-196-81-90-165-106-178-14-144-62-9-148-102-49-55-129-120-2-101-1-97-152-124-94-63-79-80-176-137-23-186-89-183-143-117-0-51-59-118-115-46-68-139-193-41-116-42-181-159-69-108-18-22-146-34-160-48-54-177-10-190-4-112-84-184"
28,74197,100,24494,98691,"122-137-23-89-183-176-80-79-151-162-127-123-149-131-65-116-43-184-35-84-112-4-190-10-177-30-54-48-160-34-146-22-18-108-69-159-181-42-5-41-193-139-68-46-115-59-118-51-133-180-135-70-154-53-100-26-86-75-44-25-16-171-175-113-56-31-78-145-179-92-57-52-185-119-40-196-81-90-165-106-178-3-14-144-62-9-148-102-49-55-129-120-2-101-1-97-152-124-94-63"
29,72639,100,24161,96800,"78-31-56-113-175-171-16-25-44-120-2-75-86-26-94-63-79-80-137-23-89-183-143-0-176-133-151-51-118-59-115-46-68-139-193-41-5-42-181-159-69-108-18-22-146-34-160-48-54-30-177-10-190-4-112-84-35-184-43-116-65-131-149-162-123-127-70-135-154-180-53-100-101-1-97-152-129-55-49-102-148-9-62-144-14-3-178-106-165-90-81-196-40-119-185-52-57-92-179-145"
30,71773,100,24102,95875,"146-181-34-160-48-54-177-10-190-4-112-84-35-184-42-43-116-65-131-149-123-127-162-151-133-135-70-180-154-53-100-26-86-75-44-25-16-171-175-113-56-31-78-145-179-92-57-52-185-119-40-196-81-90-165-106-178-14-144-62-9-148-102-49-55-129-120-2-101-1-97-152-124-94-63-79-80-176-137-23-186-89-183-143-117-0-51-59-118-115-46-68-139-41-193-159-69-108-18-22"
31,72081,100,24305,96386,"116-43-184-84-112-4-190-10-177-54-48-160-34-146-22-18-108-69-159-181-42-5-41-193-139-68-46-115-118-59-51-0-117-143-183-89-186-23-137-176-80-79-63-94-124-152-97-1-101-2-120-129-55-49-102-148-9-62-144-14-178-106-165-90-81-196-40-119-185-52-57-92-179-145-78-31-56-113-175-171-16-25-44-75-86-26-100-53-154-180-70-135-133-151-162-127-123-149-131-65"
32,71926,100,24150,96076,"22-18-108-69-139-68-46-115-118-59-51-0-117-143-183-89-186-23-137-176-80-79-63-94-124-152-97-1-101-2-120-129-55-49-102-148-9-62-144-14-178-106-165-90-81-196-40-119-185-52-57-92-179-145-78-31-56-113-175-171-16-25-44-75-86-26-100-53-154-180-70-135-133-151-162-127-123-149-131-65-116-43-184-84-112-4-190-10-177-54-48-160-34-181-42-5-41-193-159-146"
33,71951,100,24175,96126,"80-79-63-94-124-152-97-1-101-2-120-129-55-49-102-148-9-62-144-14-178-106-165-90-81-196-40-119-185-52-57-92-179-145-78-31-56-113-175-171-16-25-44-75-86-26-100-53-154-180-135-70-127-123-162-133-151-149-131-65-116-43-184-84-112-4-190-10-177-54-48-160-34-146-22-18-108-69-159-181-42-5-41-193-139-68-46-115-59-118-51-0-117-143-183-89-186-23-137-176"
34,72712,100,25041,97753,"177-54-48-34-160-181-42-43-116-41-193-159-146-22-18-108-69-139-68-46-115-118-59-65-131-149-151-51-0-117-143-183-89-186-23-137-176-80-79-63-94-124-152-97-1-101-2-120-129-55-49-102-148-9-62-144-14-178-106-165-90-81-196-40-119-185-52-57-92-179-145-78-31-56-113-175-171-16-25-44-75-86-26-100-53-154-180-70-135-133-162-123-127-112-4-84-35-184-190-10"
35,72179,100,23701,95880,"179-196-81-40-119-90-165-185-106-178-3-14-144-62-9-148-102-49-52-55-57-92-129-152-97-1-101-100-53-180-154-135-70-127-123-162-149-131-65-116-43-184-35-84-112-4-190-10-177-30-54-48-160-34-146-22-18-108-69-159-181-42-5-41-193-139-68-46-115-59-118-51-151-133-176-0-143-183-89-23-137-80-79-63-94-26-86-75-2-120-44-25-16-171-175-113-56-31-78-145"
36,72815,100,24337,97152,"16-25-44-120-2-75-86-26-94-63-79-80-137-23-89-183-143-0-176-133-151-51-118-59-115-46-68-139-193-41-5-42-181-159-69-108-18-22-146-34-160-48-54-30-177-10-190-4-112-84-35-184-43-116-65-131-149-162-123-127-70-135-154-180-53-100-101-1-97-152-129-55-49-102-148-9-62-144-14-3-178-106-165-90-81-196-40-119-185-52-57-92-179-78-145-31-56-113-175-171"
37,72813,100,23396,96209,"189-152-97-1-101-2-120-129-57-92-179-145-78-31-56-113-175-171-16-25-44-75-86-26-100-53-154-70-135-180-63-79-133-51-118-59-115-46-68-139-193-41-5-42-181-159-69-108-18-22-146-34-160-48-54-177-10-190-4-112-84-184-43-116-65-131-149-123-127-162-151-80-176-137-23-183-89-186-15-9-62-144-14-138-165-90-81-196-40-119-185-55-52-106-178-49-102-148-124-94"
38,72535,100,24864,97399,"184-43-65-131-149-123-127-162-151-133-135-70-180-154-53-100-26-86-75-44-25-16-171-175-113-56-31-78-145-179-92-57-52-185-119-40-196-81-90-165-106-178-14-144-62-9-148-102-49-55-129-120-2-101-1-97-152-124-94-63-79-80-176-137-23-186-89-183-143-117-0-51-59-118-115-46-68-139-193-41-116-42-181-159-69-108-18-22-146-34-160-48-54-177-10-190-4-112-84-35"
39,71948,100,23548,95496,"90-81-196-40-119-185-179-145-78-31-56-113-175-171-16-25-44-120-2-75-86-26-94-63-79-80-137-23-89-183-143-0-176-133-151-51-118-59-115-46-68-139-193-41-5-42-181-159-69-108-18-22-146-34-160-48-54-30-177-10-190-4-112-84-35-184-43-116-65-131-149-162-123-127-70-135-154-180-53-100-101-1-97-152-129-92-57-55-52-106-178-49-102-148-9-62-144-14-138-165"
40,73674,100,23543,97217,"125-1-101-2-120-129-57-92-179-145-78-31-56-113-175-171-16-25-44-75-86-53-154-70-135-180-63-79-133-51-118-59-115-46-68-139-193-41-5-42-181-159-69-108-18-22-146-34-160-48-54-177-10-190-4-112-84-184-43-116-65-131-149-123-127-162-151-80-176-137-23-183-89-186-15-9-62-144-14-138-165-90-81-196-40-119-185-55-52-106-178-49-102-148-124-94-100-26-97-152"
41,73131,100,23642,96773,"32-14-144-62-9-148-102-49-178-106-52-55-57-92-129-152-97-1-101-100-53-180-154-135-70-127-123-162-149-131-65-116-43-184-35-84-112-4-190-10-177-30-54-48-160-34-146-22-18-108-69-159-181-42-5-41-193-139-68-46-115-59-118-51-151-133-176-143-183-89-23-137-80-79-63-94-26-86-75-2-120-44-25-16-171-175-113-56-31-78-145-179-185-119-40-196-81-90-165-138"
42,72276,100,23766,96042,"156-127-123-162-151-133-135-70-180-154-53-100-26-86-75-44-25-16-171-175-113-56-31-78-145-179-92-57-52-185-119-40-196-81-90-165-106-178-14-144-62-9-148-102-49-55-129-120-2-101-1-97-152-124-94-63-79-80-176-137-23-186-89-183-143-117-0-51-118-59-65-116-43-42-5-115-46-68-139-41-193-159-69-108-18-22-146-181-34-160-48-54-177-10-190-184-35-84-4-112"
43,73679,100,24065,97744,"123-162-149-131-65-116-43-184-35-84-112-4-190-10-177-30-54-48-160-34-146-22-18-108-69-159-181-42-5-41-193-139-68-46-115-59-118-51-151-133-176-183-89-23-137-80-79-63-94-124-152-97-1-101-2-120-129-55-49-102-148-9-62-144-14-3-178-106-165-90-81-196-40-119-185-52-57-92-179-145-78-31-56-113-175-171-16-25-44-75-86-26-100-121-180-53-154-135-70-127"
44,71948,100,23548,95496,"9-148-102-49-178-106-52-55-57-92-129-152-97-1-101-100-53-180-154-135-70-127-123-162-149-131-65-116-43-184-35-84-112-4-190-10-177-30-54-48-160-34-146-22-18-108-69-159-181-42-5-41-193-139-68-46-115-59-118-51-151-133-176-0-143-183-89-23-137-80-79-63-94-26-86-75-2-120-44-25-16-171-175-113-56-31-78-145-179-185-119-40-196-81-90-165-138-14-144-62"
45,72462,100,24250,96712,"23-137-186-15-9-62-144-14-138-165-90-81-196-40-119-185-55-52-106-178-49-102-148-124-94-152-97-1-101-2-120-129-57-92-179-145-78-31-56-113-175-171-16-25-44-75-86-26-100-53-154-70-135-180-63-79-133-51-118-59-115-46-68-139-193-41-5-42-181-159-69-108-18-22-146-34-160-48-54-177-10-190-84-184-43-116-65-131-149-123-127-162-151-80-176-0-117-143-183-89"
46,72432,100,24371,96803,"47-116-43-184-84-112-190-10-177-54-48-160-34-146-22-18-108-69-159-181-42-5-41-193-139-68-46-115-118-59-51-0-117-143-183-89-186-23-137-176-80-79-63-94-124-152-97-1-101-2-120-129-55-49-102-148-9-62-144-14-178-106-165-90-81-196-40-119-185-52-57-92-179-145-78-31-56-113-175-171-16-25-44-75-86-26-100-53-154-180-70-135-133-151-162-127-123-149-131-65"
47,72265,100,23749,96014,"126-127-123-162-151-133-135-70-180-154-53-100-26-86-75-44-25-16-171-175-113-56-31-78-145-179-92-57-52-185-119-40-196-81-90-165-106-178-14-144-62-9-148-102-49-55-129-120-2-101-1-97-152-124-94-63-79-80-176-137-23-186-89-183-143-117-0-51-118-59-65-116-43-42-5-115-46-68-139-41-193-159-69-108-18-22-146-181-34-160-48-54-177-10-190-184-35-84-4-112"
48,73152,100,24408,97560,"142-139-68-46-115-118-59-51-0-117-143-183-89-186-23-137-176-80-79-63-94-124-152-97-1-101-2-120-129-55-49-102-148-9-62-144-14-178-106-165-90-81-196-40-119-185-52-57-92-179-145-78-31-56-113-175-171-16-25-44-75-86-26-100-53-154-180-70-135-133-151-162-127-123-149-131-65-116-43-184-84-112-190-10-177-54-48-160-34-146-22-18-108-69-159-181-42-5-41-193"
49,73532,100,22752,96284,"58-27-90-81-196-40-119-185-179-145-78-31-56-113-175-171-16-25-44-120-2-75-86-26-94-63-79-80-137-176-133-151-51-118-59-115-46-68-139-193-41-5-42-181-159-69-108-18-22-146-34-160-48-54-177-10-190-4-112-84-35-184-43-116-65-131-149-162-123-127-70-135-154-180-53-100-101-1-97-152-129-92-57-55-52-106-178-49-102-148-9-62-144-14-138-165-39-95-7-164"
50,72747,100,23227,95974,"39-27-90-81-196-40-119-185-179-145-78-31-56-113-175-171-16-25-44-120-2-75-86-26-94-63-79-80-137-23-89-183-176-133-151-51-118-59-115-46-68-139-193-41-5-42-181-159-69-108-18-22-146-34-160-48-54-30-177-10-190-4-112-84-35-184-43-116-65-131-149-162-123-127-70-135-154-180-53-100-101-1-97-152-129-92-57-55-52-106-178-49-102-148-9-62-144-14-138-165"
51,72265,100,23749,96014,"126-127-123-162-151-133-135-70-180-154-53-100-26-86-75-44-25-16-171-175-113-56-31-78-145-179-92-57-52-185-119-40-196-81-90-165-106-178-14-144-62-9-148-102-49-55-129-120-2-101-1-97-152-124-94-63-79-80-176-137-23-186-89-183-143-117-0-51-118-59-65-116-43-42-5-115-46-68-139-41-193-159-69-108-18-22-146-181-34-160-48-54-177-10-190-184-35-84-4-112"
52,72360,100,24332,96692,"158-154-70-135-180-133-151-162-127-123-149-131-65-116-43-184-84-112-190-10-177-54-48-160-34-146-22-18-108-69-159-181-42-5-41-193-139-68-46-115-59-118-51-0-117-143-183-89-186-23-137-176-80-79-63-94-124-152-97-1-101-2-120-129-55-49-102-148-9-62-144-14-178-106-165-90-81-196-40-119-185-52-57-92-179-145-78-31-56-113-175-171-16-25-44-75-86-26-100-53"
53,73894,100,24313,98207,"38-145-78-179-92-57-52-185-119-40-196-81-90-165-106-178-3-14-144-62-9-148-102-49-55-129-152-97-1-101-100-53-180-154-135-70-127-123-162-149-131-65-116-43-184-35-84-112-4-190-10-177-30-54-48-160-34-146-22-18-108-69-159-181-42-5-41-193-139-68-46-115-59-118-51-151-133-176-143-183-89-23-137-80-79-63-94-26-86-75-2-120-44-25-16-171-175-113-56-31"
54,72087,100,24311,96398,"70-154-53-100-26-86-75-44-25-16-171-175-113-56-31-78-145-179-92-57-52-185-119-40-196-81-90-165-106-178-14-144-62-9-148-102-49-55-129-120-2-101-1-97-152-124-94-63-79-80-176-137-23-186-89-183-143-117-0-51-118-59-115-46-68-139-193-41-5-42-181-159-69-108-18-22-146-34-160-48-54-177-10-190-4-112-84-184-43-116-65-131-149-123-127-162-151-133-180-135"
55,71891,100,24115,96006,"5-43-116-65-131-149-123-127-162-151-133-135-70-180-154-53-100-26-86-75-44-25-16-171-175-113-56-31-78-145-179-92-57-52-185-119-40-196-81-90-165-106-178-14-144-62-9-148-102-49-55-129-120-2-101-1-97-152-124-94-63-79-80-176-137-23-186-89-183-143-117-0-51-59-118-115-46-68-139-41-193-159-69-108-18-22-146-181-34-160-48-54-177-10-190-4-112-84-184-42"
56,72022,100,24246,96268,"149-123-127-162-151-133-135-70-180-154-53-100-26-86-75-44-25-16-171-175-113-56-31-78-145-179-92-57-52-185-119-40-196-81-90-165-106-178-14-144-62-9-148-102-49-55-129-120-2-101-1-97-152-124-94-63-79-80-176-137-23-186-89-183-143-117-0-51-118-59-115-46-68-139-193-41-5-42-181-159-69-108-18-22-146-34-160-48-54-177-10-190-4-112-84-184-43-116-65-131"
57,73273,100,23841,97114,"169-40-119-90-165-138-14-144-62-9-148-102-49-178-106-52-55-57-92-129-152-97-1-101-100-53-180-154-135-70-127-123-162-149-131-65-116-43-184-35-84-112-4-190-10-177-30-54-48-160-34-146-22-18-108-69-159-181-42-5-41-193-139-68-46-115-59-118-51-151-133-176-143-183-89-23-137-80-79-63-94-26-86-75-2-120-44-25-16-171-175-113-56-31-78-145-179-185-81-196"
58,73768,100,23977,97745,"172-92-129-152-97-1-101-100-53-180-154-135-70-127-123-162-149-131-65-116-43-184-35-84-112-4-190-10-177-30-54-48-160-34-146-22-18-108-69-159-181-42-5-41-193-139-68-46-115-59-118-51-151-133-176-143-183-89-23-137-80-79-63-94-26-86-75-2-120-44-25-16-171-175-113-56-31-78-145-179-196-81-90-40-119-165-185-106-178-3-14-144-62-9-148-102-49-52-55-57"
59,72087,100,24311,96398,"180-133-151-162-127-123-149-131-65-116-43-184-84-112-4-190-10-177-54-48-160-34-146-22-18-108-69-159-181-42-5-41-193-139-68-46-115-59-118-51-0-117-143-183-89-186-23-137-176-80-79-63-94-124-152-97-1-101-2-120-129-55-49-102-148-9-62-144-14-178-106-165-90-81-196-40-119-185-52-57-92-179-145-78-31-56-113-175-171-16-25-44-75-86-26-100-53-154-70-135"
60,72602,100,23435,96037,"137-23-183-89-186-15-9-62-144-14-138-165-90-81-196-40-119-185-55-52-106-178-49-102-148-124-94-152-97-1-101-2-120-129-57-92-179-145-78-31-56-113-175-171-16-25-44-75-86-26-100-53-154-70-135-180-63-79-133-51-118-59-115-46-68-139-193-41-5-42-181-159-69-108-18-22-146-34-160-48-54-177-10-190-4-112-84-35-184-43-116-65-131-149-123-127-162-151-80-176"
61,72594,100,23799,96393,"15-144-14-138-165-90-81-196-40-119-185-179-145-78-31-56-113-175-171-16-25-44-120-2-75-86-26-94-63-79-80-137-23-89-183-143-176-133-151-51-118-59-115-46-68-139-193-41-5-42-181-159-69-108-18-22-146-34-160-48-54-30-177-10-190-4-112-84-35-184-43-116-65-131-149-162-123-127-70-135-154-180-53-100-101-1-97-152-129-92-57-55-52-106-178-49-102-62-9-148"
62,72639,100,24161,96800,"92-57-52-185-119-40-196-81-90-165-106-178-3-14-144-62-9-148-102-49-55-129-152-97-1-101-100-53-180-154-135-70-127-123-162-149-131-65-116-43-184-35-84-112-4-190-10-177-30-54-48-160-34-146-22-18-108-69-159-181-42-5-41-193-139-68-46-115-59-118-51-151-133-176-0-143-183-89-23-137-80-79-63-94-26-86-75-2-120-44-25-16-171-175-113-56-31-78-145-179"
63,72639,100,24161,96800,"78-31-56-113-175-171-16-25-44-120-2-75-86-26-94-63-79-80-137-23-89-183-143-0-176-133-151-51-118-59-115-46-68-139-193-41-5-42-181-159-69-108-18-22-146-34-160-48-54-30-177-10-190-4-112-84-35-184-43-116-65-131-149-162-123-127-70-135-154-180-53-100-101-1-97-152-129-55-49-102-148-9-62-144-14-3-178-106-165-90-81-196-40-119-185-52-57-92-179-145"
64,71948,100,23548,95496,"178-49-102-148-9-62-144-14-138-165-90-81-196-40-119-185-179-145-78-31-56-113-175-171-16-25-44-120-2-75-86-26-94-63-79-80-137-23-89-183-143-0-176-133-151-51-118-59-115-46-68-139-193-41-5-42-181-159-69-108-18-22-146-34-160-48-54-30-177-10-190-4-112-84-35-184-43-116-65-131-149-162-123-127-70-135-154-180-53-100-101-1-97-152-129-92-57-55-52-106"
65,72815,100,24337,97152,"31-145-78-179-92-57-52-185-119-40-196-81-90-165-106-178-3-14-144-62-9-148-102-49-55-129-152-97-1-101-100-53-180-154-135-70-127-123-162-149-131-65-116-43-184-35-84-112-4-190-10-177-30-54-48-160-34-146-22-18-108-69-159-181-42-5-41-193-139-68-46-115-59-118-51-151-133-176-0-143-183-89-23-137-80-79-63-94-26-86-75-2-120-44-25-16-171-175-113-56"
66,71948,100,23548,95496,"40-196-81-90-165-138-14-144-62-9-148-102-49-178-106-52-55-57-92-129-152-97-1-101-100-53-180-154-135-70-127-123-162-149-131-65-116-43-184-35-84-112-4-190-10-177-30-54-48-160-34-146-22-18-108-69-159-181-42-5-41-193-139-68-46-115-59-118-51-151-133-176-0-143-183-89-23-137-80-79-63-94-26-86-75-2-120-44-25-16-171-175-113-56-31-78-145-179-185-119"
67,71773,100,24102,95875,"146-181-34-160-48-54-177-10-190-4-112-84-35-184-42-43-116-65-131-149-123-127-162-151-133-135-70-180-154-53-100-26-86-75-44-25-16-171-175-113-56-31-78-145-179-92-57-52-185-119-40-196-81-90-165-106-178-14-144-62-9-148-102-49-55-129-120-2-101-1-97-152-124-94-63-79-80-176-137-23-186-89-183-143-117-0-51-59-118-115-46-68-139-41-193-159-69-108-18-22"
68,73373,100,22852,96225,"164-27-90-81-196-40-119-185-179-145-78-31-56-113-175-171-16-25-44-120-2-75-86-26-94-63-79-80-137-176-133-151-51-118-59-115-46-68-139-193-41-5-42-181-159-69-108-18-22-146-34-160-48-54-30-177-10-190-4-112-84-35-184-43-116-65-131-149-162-123-127-70-135-154-180-53-100-101-1-97-152-129-92-57-55-52-106-178-49-102-148-9-62-144-14-138-165-39-95-7"
69,72081,100,24305,96386,"139-68-46-115-118-59-51-0-117-143-183-89-186-23-137-176-80-79-63-94-124-152-97-1-101-2-120-129-55-49-102-148-9-62-144-14-178-106-165-90-81-196-40-119-185-52-57-92-179-145-78-31-56-113-175-171-16-25-44-75-86-26-100-53-154-180-70-135-133-151-162-127-123-149-131-65-116-43-184-84-112-4-190-10-177-54-48-160-34-146-22-18-108-69-159-181-42-5-41-193"
70,71773,100,24102,95875,"160-48-54-177-10-190-4-112-84-35-184-42-43-116-65-131-149-123-127-162-151-133-135-70-180-154-53-100-26-86-75-44-25-16-171-175-113-56-31-78-145-179-92-57-52-185-119-40-196-81-90-165-106-178-14-144-62-9-148-102-49-55-129-120-2-101-1-97-152-124-94-63-79-80-176-137-23-186-89-183-143-117-0-51-59-118-115-46-68-139-41-193-159-69-108-18-22-146-181-34"
71,72087,100,24311,96398,"63-79-80-176-137-23-186-89-183-143-117-0-51-118-59-115-46-68-139-193-41-5-42-181-159-69-108-18-22-146-34-160-48-54-177-10-190-4-112-84-184-43-116-65-131-149-123-127-162-151-133-180-135-70-154-53-100-26-86-75-44-25-16-171-175-113-56-31-78-145-179-92-57-52-185-119-40-196-81-90-165-106-178-14-144-62-9-148-102-49-55-129-120-2-101-1-97-152-124-94"
72,72815,100,24337,97152,"56-31-145-78-179-92-57-52-185-119-40-196-81-90-165-106-178-3-14-144-62-9-148-102-49-55-129-152-97-1-101-100-53-180-154-135-70-127-123-162-149-131-65-116-43-184-35-84-112-4-190-10-177-30-54-48-160-34-146-22-18-108-69-159-181-42-5-41-193-139-68-46-115-59-118-51-151-133-176-0-143-183-89-23-137-80-79-63-94-26-86-75-2-120-44-25-16-171-175-113"
73,72462,100,24250,96712,"183-143-117-0-176-80-151-162-127-123-149-131-65-116-43-184-84-190-10-177-54-48-160-34-146-22-18-108-69-159-181-42-5-41-193-139-68-46-115-59-118-51-133-79-63-180-135-70-154-53-100-26-86-75-44-25-16-171-175-113-56-31-78-145-179-92-57-129-120-2-101-1-97-152-94-124-148-102-49-178-106-52-55-185-119-40-196-81-90-165-138-14-144-62-9-15-186-137-23-89"
74,72982,100,24264,97246,"141-51-118-59-115-46-68-139-193-41-5-42-181-159-69-108-18-22-146-34-160-48-54-177-10-190-112-84-184-43-116-65-131-149-123-127-162-151-133-135-70-180-154-53-100-26-86-75-44-25-16-171-175-113-56-31-78-145-179-92-57-52-185-119-40-196-81-90-165-106-178-14-144-62-9-148-102-49-55-129-120-2-101-1-97-152-124-94-63-79-80-176-137-23-186-89-183-143-117-0"
75,73031,100,23503,96534,"155-14-138-165-90-81-196-40-119-185-179-145-78-31-56-113-175-171-16-25-44-120-2-75-86-26-94-63-79-80-137-23-89-183-143-176-133-151-51-118-59-115-46-68-139-193-41-5-42-181-159-69-108-18-22-146-34-160-48-54-30-177-10-190-4-112-84-35-184-43-116-65-131-149-162-123-127-70-135-154-180-53-100-101-1-97-152-129-92-57-55-52-106-178-49-102-148-9-62-144"
76,72752,100,23585,96337,"97-26-100-94-124-148-102-49-178-106-52-55-185-119-40-196-81-90-165-138-14-144-62-9-15-186-89-183-23-137-176-80-151-162-127-123-149-131-65-116-43-184-35-84-112-4-190-10-177-54-48-160-34-146-22-18-108-69-159-181-42-5-41-193-139-68-46-115-59-118-51-133-79-63-180-135-70-154-53-86-75-44-25-16-171-175-113-56-31-78-145-179-92-57-129-120-2-101-1-152"
77,72845,100,24799,97644,"77-43-184-84-112-4-190-10-177-54-48-160-34-146-22-18-108-69-159-181-42-116-41-193-139-68-46-115-118-59-51-0-117-143-183-89-186-23-137-176-80-79-63-94-124-152-97-1-101-2-120-129-55-49-102-148-9-62-144-14-178-106-165-90-81-196-40-119-185-52-57-92-179-145-78-31-56-113-175-171-16-25-44-75-86-26-100-53-154-180-70-135-133-151-162-127-123-149-131-65"
78,72674,100,23389,96063,"121-100-26-86-75-44-25-16-171-175-113-56-31-78-145-179-92-57-129-120-2-101-1-97-152-94-124-148-102-49-178-106-52-55-185-119-40-196-81-90-165-138-14-144-62-9-15-186-89-183-23-137-176-80-151-162-127-123-149-131-65-116-43-184-84-112-4-190-10-177-54-48-160-34-146-22-18-108-69-159-181-42-5-41-193-139-68-46-115-59-118-51-133-79-63-180-135-70-154-53"
79,72752,100,23585,96337,"152-1-101-2-120-129-57-92-179-145-78-31-56-113-175-171-16-25-44-75-86-53-154-70-135-180-63-79-133-51-118-59-115-46-68-139-193-41-5-42-181-159-69-108-18-22-146-34-160-48-54-177-10-190-4-112-84-35-184-43-116-65-131-149-123-127-162-151-80-176-137-23-183-89-186-15-9-62-144-14-138-165-90-81-196-40-119-185-55-52-106-178-49-102-148-124-94-100-26-97"
80,72712,100,25041,97753,"177-54-48-34-160-181-42-43-116-41-193-159-146-22-18-108-69-139-68-46-115-118-59-65-131-149-151-51-0-117-143-183-89-186-23-137-176-80-79-63-94-124-152-97-1-101-2-120-129-55-49-102-148-9-62-144-14-178-106-165-90-81-196-40-119-185-52-57-92-179-145-78-31-56-113-175-171-16-25-44-75-86-26-100-53-154-180-70-135-133-162-123-127-112-4-84-35-184-190-10"
81,71732,100,23497,95229,"170-117-0-46-68-139-193-41-115-5-42-181-159-69-108-18-22-146-34-160-48-54-177-10-190-4-112-84-35-184-43-116-65-59-118-51-151-133-162-123-127-70-135-180-154-53-100-26-86-75-44-25-16-171-175-113-56-31-78-145-179-92-57-52-185-119-40-196-81-90-165-106-178-14-144-62-9-148-102-49-55-129-120-2-101-1-97-152-124-94-63-79-80-176-137-23-186-89-183-143"
82,72845,100,24799,97644,"77-43-184-84-112-4-190-10-177-54-48-160-34-146-22-18-108-69-159-181-42-116-41-193-139-68-46-115-118-59-51-0-117-143-183-89-186-23-137-176-80-79-63-94-124-152-97-1-101-2-120-129-55-49-102-148-9-62-144-14-178-106-165-90-81-196-40-119-185-52-57-92-179-145-78-31-56-113-175-171-16-25-44-75-86-26-100-53-154-180-70-135-133-151-162-127-123-149-131-65"
83,73353,100,23475,96828,"130-124-148-102-49-178-106-52-55-185-119-40-196-81-90-165-138-14-144-62-9-15-186-89-183-23-137-176-80-151-162-127-123-149-131-65-116-43-184-84-112-4-190-10-177-54-48-160-34-146-22-18-108-69-159-181-42-5-41-193-139-68-46-115-59-118-51-133-79-63-180-135-70-154-53-100-26-86-75-44-25-16-171-175-113-56-31-78-145-179-92-57-129-120-2-101-1-97-152-94"
84,72087,100,24311,96398,"63-79-80-176-137-23-186-89-183-143-117-0-51-118-59-115-46-68-139-193-41-5-42-181-159-69-108-18-22-146-34-160-48-54-177-10-190-4-112-84-184-43-116-65-131-149-123-127-162-151-133-180-135-70-154-53-100-26-86-75-44-25-16-171-175-113-56-31-78-145-179-92-57-52-185-119-40-196-81-90-165-106-178-14-144-62-9-148-102-49-55-129-120-2-101-1-97-152-124-94"
85,72129,100,24353,96482,"42-181-159-69-108-18-22-146-34-160-48-54-177-10-190-4-112-84-184-43-116-65-131-149-123-127-162-151-133-135-70-180-154-53-100-26-86-75-44-25-16-171-175-113-56-31-78-145-179-92-57-52-185-119-40-196-81-90-165-106-178-14-144-62-9-148-102-49-55-129-120-2-101-1-97-152-124-94-63-79-80-176-137-23-186-89-183-143-117-0-51-59-118-115-46-68-139-41-193-5"
86,72920,100,24748,97668,"28-43-65-131-149-123-127-162-151-133-135-70-180-154-53-100-26-86-75-44-25-16-171-175-113-56-31-78-145-179-92-57-52-185-119-40-196-81-90-165-106-178-14-144-62-9-148-102-49-55-129-120-2-101-1-97-152-124-94-63-79-80-176-137-23-186-89-183-143-117-0-51-59-118-115-46-68-139-193-41-116-42-181-159-69-108-18-22-146-34-160-48-54-177-10-190-4-112-84-184"
87,73918,100,24318,98236,"85-31-145-78-179-92-57-52-185-119-40-196-81-90-165-106-178-3-14-144-62-9-148-102-49-55-129-152-97-1-101-100-53-180-154-135-70-127-123-162-149-131-65-116-43-184-35-84-112-4-190-10-177-30-54-48-160-34-146-22-18-108-69-159-181-42-5-41-193-139-68-46-115-59-118-51-151-133-176-143-183-89-23-137-80-79-63-94-26-86-75-2-120-44-25-16-171-175-113-56"
88,72747,100,23227,95974,"39-27-90-81-196-40-119-185-179-145-78-31-56-113-175-171-16-25-44-120-2-75-86-26-94-63-79-80-137-23-89-183-176-133-151-51-118-59-115-46-68-139-193-41-5-42-181-159-69-108-18-22-146-34-160-48-54-30-177-10-190-4-112-84-35-184-43-116-65-131-149-162-123-127-70-135-154-180-53-100-101-1-97-152-129-92-57-55-52-106-178-49-102-148-9-62-144-14-138-165"
89,71948,100,23548,95496,"148-102-49-178-106-52-55-57-92-129-152-97-1-101-100-53-180-154-135-70-127-123-162-149-131-65-116-43-184-35-84-112-4-190-10-177-30-54-48-160-34-146-22-18-108-69-159-181-42-5-41-193-139-68-46-115-59-118-51-151-133-176-0-143-183-89-23-137-80-79-63-94-26-86-75-2-120-44-25-16-171-175-113-56-31-78-145-179-185-119-40-196-81-90-165-138-14-144-62-9"
90,72985,100,24475,97460,"197-116-65-59-118-51-0-117-143-183-89-186-23-137-176-80-79-63-94-124-152-97-1-101-2-120-129-55-49-102-148-9-62-144-14-178-106-165-90-81-196-40-119-185-52-57-92-179-145-78-31-56-113-175-171-16-25-44-75-86-26-100-53-154-180-70-135-133-151-162-127-123-149-131-43-184-84-112-190-10-177-54-48-160-34-146-22-18-108-69-159-181-42-5-41-193-139-68-46-115"
91,71732,100,23497,95229,"170-117-0-46-68-139-193-41-115-5-42-181-159-69-108-18-22-146-34-160-48-54-177-10-190-4-112-84-35-184-43-116-65-59-118-51-151-133-162-123-127-70-135-180-154-53-100-26-86-75-44-25-16-171-175-113-56-31-78-145-179-92-57-52-185-119-40-196-81-90-165-106-178-14-144-62-9-148-102-49-55-129-120-2-101-1-97-152-124-94-63-79-80-176-137-23-186-89-183-143"
92,72087,100,24311,96398,"135-180-133-151-162-127-123-149-131-65-116-43-184-84-112-4-190-10-177-54-48-160-34-146-22-18-108-69-159-181-42-5-41-193-139-68-46-115-59-118-51-0-117-143-183-89-186-23-137-176-80-79-63-94-124-152-97-1-101-2-120-129-55-49-102-148-9-62-144-14-178-106-165-90-81-196-40-119-185-52-57-92-179-145-78-31-56-113-175-171-16-25-44-75-86-26-100-53-154-70"
93,72087,100,24311,96398,"53-154-70-135-180-133-151-162-127-123-149-131-65-116-43-184-84-112-4-190-10-177-54-48-160-34-146-22-18-108-69-159-181-42-5-41-193-139-68-46-115-59-118-51-0-117-143-183-89-186-23-137-176-80-79-63-94-124-152-97-1-101-2-120-129-55-49-102-148-9-62-144-14-178-106-165-90-81-196-40-119-185-52-57-92-179-145-78-31-56-113-175-171-16-25-44-75-86-26-100"
94,72752,100,23585,96337,"152-1-101-2-120-129-57-92-179-145-78-31-56-113-175-171-16-25-44-75-86-53-154-70-135-180-63-79-133-51-118-59-115-46-68-139-193-41-5-42-181-159-69-108-18-22-146-34-160-48-54-177-10-190-4-112-84-35-184-43-116-65-131-149-123-127-162-151-80-176-137-23-183-89-186-15-9-62-144-14-138-165-90-81-196-40-119-185-55-52-106-178-49-102-148-124-94-100-26-97"
95,72815,100,24337,97152,"16-25-44-120-2-75-86-26-94-63-79-80-137-23-89-183-143-0-176-133-151-51-118-59-115-46-68-139-193-41-5-42-181-159-69-108-18-22-146-34-160-48-54-30-177-10-190-4-112-84-35-184-43-116-65-131-149-162-123-127-70-135-154-180-53-100-101-1-97-152-129-55-49-102-148-9-62-144-14-3-178-106-165-90-81-196-40-119-185-52-57-92-179-78-145-31-56-113-175-171"
96,72639,100,24161,96800,"25-44-120-2-75-86-26-94-63-79-80-137-23-89-183-143-0-176-133-151-51-118-59-115-46-68-139-193-41-5-42-181-159-69-108-18-22-146-34-160-48-54-30-177-10-190-4-112-84-35-184-43-116-65-131-149-162-123-127-70-135-154-180-53-100-101-1-97-152-129-55-49-102-148-9-62-144-14-3-178-106-165-90-81-196-40-119-185-52-57-92-179-145-78-31-56-113-175-171-16"
97,72752,100,23585,96337,"101-1-152-97-26-100-94-124-148-102-49-178-106-52-55-185-119-40-196-81-90-165-138-14-144-62-9-15-186-89-183-23-137-176-80-151-162-127-123-149-131-65-116-43-184-35-84-112-4-190-10-177-54-48-160-34-146-22-18-108-69-159-181-42-5-41-193-139-68-46-115-59-118-51-133-79-63-180-135-70-154-53-86-75-44-25-16-171-175-113-56-31-78-145-179-92-57-129-120-2"
98,73649,100,23166,96815,"17-196-81-90-40-119-165-185-106-178-3-14-144-62-9-148-102-49-52-55-57-179-145-78-92-129-152-97-1-101-100-53-180-154-135-70-127-123-162-149-131-65-116-43-184-35-84-112-4-190-10-177-30-54-48-160-34-146-22-18-108-69-159-181-42-5-41-193-139-68-46-115-59-118-51-151-133-176-183-89-23-137-80-79-63-94-26-86-75-2-120-44-25-16-171-175-113-56-31-157"
99,72265,100,23749,96014,"126-127-123-162-151-133-135-70-180-154-53-100-26-86-75-44-25-16-171-175-113-56-31-78-145-179-92-57-52-185-119-40-196-81-90-165-106-178-14-144-62-9-148-102-49-55-129-120-2-101-1-97-152-124-94-63-79-80-176-137-23-186-89-183-143-117-0-51-118-59-65-116-43-42-5-115-46-68-139-41-193-159-69-108-18-22-146-181-34-160-48-54-177-10-190-184-35-84-4-112"
100,71951,100,24175,96126,"176-137-23-186-89-183-143-117-0-51-118-59-115-46-68-139-193-41-5-42-181-159-69-108-18-22-146-34-160-48-54-177-10-190-4-112-84-184-43-116-65-131-149-151-133-162-123-127-70-135-180-154-53-100-26-86-75-44-25-16-171-175-113-56-31-78-145-179-92-57-52-185-119-40-196-81-90-165-106-178-14-144-62-9-148-102-49-55-129-120-2-101-1-97-152-124-94-63-79-80"
101,73679,100,24065,97744,"127-70-135-154-53-180-121-100-26-86-75-44-25-16-171-175-113-56-31-78-145-179-92-57-52-185-119-40-196-81-90-165-106-178-3-14-144-62-9-148-102-49-55-129-120-2-101-1-97-152-124-94-63-79-80-137-23-89-183-176-133-151-51-118-59-115-46-68-139-193-41-5-42-181-159-69-108-18-22-146-34-160-48-54-30-177-10-190-4-112-84-35-184-43-116-65-131-149-162-123"
102,72980,100,24302,97282,"21-144-62-9-148-102-49-178-106-52-55-57-92-129-152-97-1-101-100-53-180-154-135-70-127-123-162-149-131-65-116-43-184-35-84-112-4-190-10-177-30-54-48-160-34-146-22-18-108-69-159-181-42-5-41-193-139-68-46-115-59-118-51-151-133-176-143-183-89-23-137-80-79-63-94-26-86-75-2-120-44-25-16-171-175-113-56-31-78-145-179-185-119-40-196-81-90-165-138-14"
103,73679,100,24065,97744,"123-162-149-131-65-116-43-184-35-84-112-4-190-10-177-30-54-48-160-34-146-22-18-108-69-159-181-42-5-41-193-139-68-46-115-59-118-51-151-133-176-183-89-23-137-80-79-63-94-124-152-97-1-101-2-120-129-55-49-102-148-9-62-144-14-3-178-106-165-90-81-196-40-119-185-52-57-92-179-145-78-31-56-113-175-171-16-25-44-75-86-26-100-121-180-53-154-135-70-127"
104,73129,100,23590,96719,"187-196-40-119-185-179-145-78-31-56-113-175-171-16-25-44-120-2-75-86-26-94-63-79-80-137-23-89-183-143-176-133-151-51-118-59-115-46-68-139-193-41-5-42-181-159-69-108-18-22-146-34-160-48-54-30-177-10-190-4-112-84-35-184-43-116-65-131-149-162-123-127-70-135-154-180-53-100-101-1-97-152-129-92-57-55-52-106-178-49-102-148-9-62-144-14-138-165-90-81"
105,71926,100,24150,96076,"159-146-22-18-108-69-139-68-46-115-118-59-51-0-117-143-183-89-186-23-137-176-80-79-63-94-124-152-97-1-101-2-120-129-55-49-102-148-9-62-144-14-178-106-165-90-81-196-40-119-185-52-57-92-179-145-78-31-56-113-175-171-16-25-44-75-86-26-100-53-154-180-70-135-133-151-162-127-123-149-131-65-116-43-184-84-112-4-190-10-177-54-48-160-34-181-42-5-41-193"
106,72530,100,24318,96848,"186-89-183-143-117-0-176-80-151-162-127-123-149-131-65-116-43-184-84-190-10-177-54-48-160-34-146-22-18-108-69-159-181-42-5-41-193-139-68-46-115-59-118-51-133-79-63-180-135-70-154-53-100-26-86-75-44-25-16-171-175-113-56-31-78-145-179-92-57-129-120-2-101-1-97-152-94-124-148-102-49-178-106-52-55-185-119-40-196-81-90-165-138-14-144-62-9-15-137-23"
107,72602,100,23435,96037,"86-26-100-53-154-70-135-180-63-79-133-51-118-59-115-46-68-139-193-41-5-42-181-159-69-108-18-22-146-34-160-48-54-177-10-190-4-112-84-35-184-43-116-65-131-149-123-127-162-151-80-176-137-23-183-89-186-15-9-62-144-14-138-165-90-81-196-40-119-185-55-52-106-178-49-102-148-124-94-152-97-1-101-2-120-129-57-92-179-145-78-31-56-113-175-171-16-25-44-75"
108,72639,100,24161,96800,"129-55-49-102-148-9-62-144-14-3-178-106-165-90-81-196-40-119-185-52-57-92-179-145-78-31-56-113-175-171-16-25-44-120-2-75-86-26-94-63-79-80-137-23-89-183-143-0-176-133-151-51-118-59-115-46-68-139-193-41-5-42-181-159-69-108-18-22-146-34-160-48-54-30-177-10-190-4-112-84-35-184-43-116-65-131-149-162-123-127-70-135-154-180-53-100-101-1-97-152"
109,72081,100,24305,96386,"59-118-115-46-68-139-193-41-5-42-181-159-69-108-18-22-146-34-160-48-54-177-10-190-4-112-84-184-43-116-65-131-149-123-127-162-151-133-135-70-180-154-53-100-26-86-75-44-25-16-171-175-113-56-31-78-145-179-92-57-52-185-119-40-196-81-90-165-106-178-14-144-62-9-148-102-49-55-129-120-2-101-1-97-152-124-94-63-79-80-176-137-23-186-89-183-143-117-0-51"
110,73532,100,22752,96284,"58-27-90-81-196-40-119-185-179-145-78-31-56-113-175-171-16-25-44-120-2-75-86-26-94-63-79-80-137-176-133-151-51-118-59-115-46-68-139-193-41-5-42-181-159-69-108-18-22-146-34-160-48-54-177-10-190-4-112-84-35-184-43-116-65-131-149-162-123-127-70-135-154-180-53-100-101-1-97-152-129-92-57-55-52-106-178-49-102-148-9-62-144-14-138-165-39-95-7-164"
111,72980,100,24302,97282,"21-144-62-9-148-102-49-178-106-52-55-57-92-129-152-97-1-101-100-53-180-154-135-70-127-123-162-149-131-65-116-43-184-35-84-112-4-190-10-177-30-54-48-160-34-146-22-18-108-69-159-181-42-5-41-193-139-68-46-115-59-118-51-151-133-176-143-183-89-23-137-80-79-63-94-26-86-75-2-120-44-25-16-171-175-113-56-31-78-145-179-185-119-40-196-81-90-165-138-14"
112,71948,100,23548,95496,"40-196-81-90-165-138-14-144-62-9-148-102-49-178-106-52-55-57-92-129-152-97-1-101-100-53-180-154-135-70-127-123-162-149-131-65-116-43-184-35-84-112-4-190-10-177-30-54-48-160-34-146-22-18-108-69-159-181-42-5-41-193-139-68-46-115-59-118-51-151-133-176-0-143-183-89-23-137-80-79-63-94-26-86-75-2-120-44-25-16-171-175-113-56-31-78-145-179-185-119"
113,73249,100,23629,96878,"174-119-40-185-179-145-78-31-56-113-175-171-16-25-44-120-2-75-86-26-94-63-79-80-137-23-89-183-143-176-133-151-51-118-59-115-46-68-139-193-41-5-42-181-159-69-108-18-22-146-34-160-48-54-30-177-10-190-4-112-84-35-184-43-116-65-131-149-162-123-127-70-135-154-180-53-100-101-1-97-152-129-92-57-55-52-106-178-49-102-148-9-62-144-14-138-165-90-81-196"
114,72081,100,24305,96386,"193-139-68-46-115-118-59-51-0-117-143-183-89-186-23-137-176-80-79-63-94-124-152-97-1-101-2-120-129-55-49-102-148-9-62-144-14-178-106-165-90-81-196-40-119-185-52-57-92-179-145-78-31-56-113-175-171-16-25-44-75-86-26-100-53-154-180-70-135-133-151-162-127-123-149-131-65-116-43-184-84-112-4-190-10-177-54-48-160-34-146-22-18-108-69-159-181-42-5-41"
115,72639,100,24161,96800,"92-57-52-185-119-40-196-81-90-165-106-178-3-14-144-62-9-148-102-49-55-129-152-97-1-101-100-53-180-154-135-70-127-123-162-149-131-65-116-43-184-35-84-112-4-190-10-177-30-54-48-160-34-146-22-18-108-69-159-181-42-5-41-193-139-68-46-115-59-118-51-151-133-176-0-143-183-89-23-137-80-79-63-94-26-86-75-2-120-44-25-16-171-175-113-56-31-78-145-179"
116,72639,100,24161,96800,"44-25-16-171-175-113-56-31-78-145-179-92-57-52-185-119-40-196-81-90-165-106-178-3-14-144-62-9-148-102-49-55-129-152-97-1-101-100-53-180-154-135-70-127-123-162-149-131-65-116-43-184-35-84-112-4-190-10-177-30-54-48-160-34-146-22-18-108-69-159-181-42-5-41-193-139-68-46-115-59-118-51-151-133-176-0-143-183-89-23-137-80-79-63-94-26-86-75-2-120"
117,72815,100,24337,97152,"171-16-25-44-120-2-75-86-26-94-63-79-80-137-23-89-183-143-0-176-133-151-51-118-59-115-46-68-139-193-41-5-42-181-159-69-108-18-22-146-34-160-48-54-30-177-10-190-4-112-84-35-184-43-116-65-131-149-162-123-127-70-135-154-180-53-100-101-1-97-152-129-55-49-102-148-9-62-144-14-3-178-106-165-90-81-196-40-119-185-52-57-92-179-78-145-31-56-113-175"
118,73273,100,23841,97114,"169-40-119-90-165-138-14-144-62-9-148-102-49-178-106-52-55-57-92-129-152-97-1-101-100-53-180-154-135-70-127-123-162-149-131-65-116-43-184-35-84-112-4-190-10-177-30-54-48-160-34-146-22-18-108-69-159-181-42-5-41-193-139-68-46-115-59-118-51-151-133-176-143-183-89-23-137-80-79-63-94-26-86-75-2-120-44-25-16-171-175-113-56-31-78-145-179-185-81-196"
119,72637,100,24381,97018,"105-116-43-184-84-112-190-10-177-54-48-160-34-146-22-18-108-69-159-181-42-5-41-193-139-68-46-115-118-59-51-0-117-143-183-89-186-23-137-176-80-79-63-94-124-152-97-1-101-2-120-129-55-49-102-148-9-62-144-14-178-106-165-90-81-196-40-119-185-52-57-92-179-145-78-31-56-113-175-171-16-25-44-75-86-26-100-53-154-180-70-135-133-151-162-127-123-149-131-65"
120,72022,100,24246,96268,"131-149-123-127-162-151-133-135-70-180-154-53-100-26-86-75-44-25-16-171-175-113-56-31-78-145-179-92-57-52-185-119-40-196-81-90-165-106-178-14-144-62-9-148-102-49-55-129-120-2-101-1-97-152-124-94-63-79-80-176-137-23-186-89-183-143-117-0-51-118-59-115-46-68-139-193-41-5-42-181-159-69-108-18-22-146-34-160-48-54-177-10-190-4-112-84-184-43-116-65"
121,72772,100,24326,97098,"191-193-41-5-42-181-159-69-108-18-22-146-34-160-48-54-177-10-190-112-84-184-43-116-65-131-149-123-127-162-151-133-135-70-180-154-53-100-26-86-75-44-25-16-171-175-113-56-31-78-145-179-92-57-52-185-119-40-196-81-90-165-106-178-14-144-62-9-148-102-49-55-129-120-2-101-1-97-152-124-94-63-79-80-176-137-23-186-89-183-143-117-0-51-59-118-115-46-68-139"
122,73649,100,23166,96815,"17-196-81-90-40-119-165-185-106-178-3-14-144-62-9-148-102-49-52-55-57-179-145-78-92-129-152-97-1-101-100-53-180-154-135-70-127-123-162-149-131-65-116-43-184-35-84-112-4-190-10-177-30-54-48-160-34-146-22-18-108-69-159-181-42-5-41-193-139-68-46-115-59-118-51-151-133-176-183-89-23-137-80-79-63-94-26-86-75-2-120-44-25-16-171-175-113-56-31-157"
123,73729,100,23603,97332,"150-2-120-129-57-92-179-145-78-31-56-113-175-171-16-25-44-75-86-53-154-70-135-180-63-79-133-51-118-59-115-46-68-139-193-41-5-42-181-159-69-108-18-22-146-34-160-48-54-177-10-190-4-112-84-184-43-116-65-131-149-123-127-162-151-80-176-137-23-183-89-186-15-9-62-144-14-138-165-90-81-196-40-119-185-55-52-106-178-49-102-148-124-94-100-26-1-152-97-101"
124,72602,100,23435,96037,"100-26-86-75-44-25-16-171-175-113-56-31-78-145-179-92-57-129-120-2-101-1-97-152-94-124-148-102-49-178-106-52-55-185-119-40-196-81-90-165-138-14-144-62-9-15-186-89-183-23-137-176-80-151-162-127-123-149-131-65-116-43-184-35-84-112-4-190-10-177-54-48-160-34-146-22-18-108-69-159-181-42-5-41-193-139-68-46-115-59-118-51-133-79-63-180-135-70-154-53"
125,71948,100,23548,95496,"106-52-55-57-92-129-152-97-1-101-100-53-180-154-135-70-127-123-162-149-131-65-116-43-184-35-84-112-4-190-10-177-30-54-48-160-34-146-22-18-108-69-159-181-42-5-41-193-139-68-46-115-59-118-51-151-133-176-0-143-183-89-23-137-80-79-63-94-26-86-75-2-120-44-25-16-171-175-113-56-31-78-145-179-185-119-40-196-81-90-165-138-14-144-62-9-148-102-49-178"
126,72129,100,24353,96482,"42-181-159-69-108-18-22-146-34-160-48-54-177-10-190-4-112-84-184-43-116-65-131-149-123-127-162-151-133-135-70-180-154-53-100-26-86-75-44-25-16-171-175-113-56-31-78-145-179-92-57-52-185-119-40-196-81-90-165-106-178-14-144-62-9-148-102-49-55-129-120-2-101-1-97-152-124-94-63-79-80-176-137-23-186-89-183-143-117-0-51-59-118-115-46-68-139-41-193-5"
127,73894,100,24313,98207,"38-145-78-179-92-57-52-185-119-40-196-81-90-165-106-178-3-14-144-62-9-148-102-49-55-129-152-97-1-101-100-53-180-154-135-70-127-123-162-149-131-65-116-43-184-35-84-112-4-190-10-177-30-54-48-160-34-146-22-18-108-69-159-181-42-5-41-193-139-68-46-115-59-118-51-151-133-176-143-183-89-23-137-80-79-63-94-26-86-75-2-120-44-25-16-171-175-113-56-31"
128,72081,100,24305,96386,"46-115-118-59-51-0-117-143-183-89-186-23-137-176-80-79-63-94-124-152-97-1-101-2-120-129-55-49-102-148-9-62-144-14-178-106-165-90-81-196-40-119-185-52-57-92-179-145-78-31-56-113-175-171-16-25-44-75-86-26-100-53-154-180-70-135-133-151-162-127-123-149-131-65-116-43-184-84-112-4-190-10-177-54-48-160-34-146-22-18-108-69-159-181-42-5-41-193-139-68"
129,71488,100,23578,95066,"0-46-68-139-193-41-115-5-42-181-159-69-108-18-22-146-34-160-48-54-30-177-10-190-4-112-84-35-184-43-116-65-59-118-51-151-133-162-123-127-70-135-180-154-53-100-26-86-75-44-25-16-171-175-113-56-31-78-145-179-92-57-52-185-119-40-196-81-90-165-106-178-14-144-62-9-148-102-49-55-129-120-2-101-1-97-152-124-94-63-79-80-176-137-23-186-89-183-143-117"
130,72087,100,24311,96398,"154-53-100-26-86-75-44-25-16-171-175-113-56-31-78-145-179-92-57-52-185-119-40-196-81-90-165-106-178-14-144-62-9-148-102-49-55-129-120-2-101-1-97-152-124-94-63-79-80-176-137-23-186-89-183-143-117-0-51-118-59-115-46-68-139-193-41-5-42-181-159-69-108-18-22-146-34-160-48-54-177-10-190-4-112-84-184-43-116-65-131-149-123-127-162-151-133-180-135-70"
131,71761,100,23851,95612,"84-4-112-127-123-162-151-133-135-70-180-154-53-100-26-86-75-44-25-16-171-175-113-56-31-78-145-179-92-57-52-185-119-40-196-81-90-165-106-178-14-144-62-9-148-102-49-55-129-120-2-101-1-97-152-124-94-63-79-80-176-137-23-186-89-183-143-117-0-51-118-59-65-116-43-42-5-115-46-68-139-41-193-159-69-108-18-22-146-181-34-160-48-54-30-177-10-190-184-35"
132,71948,100,23548,95496,"49-102-148-9-62-144-14-138-165-90-81-196-40-119-185-179-145-78-31-56-113-175-171-16-25-44-120-2-75-86-26-94-63-79-80-137-23-89-183-143-0-176-133-151-51-118-59-115-46-68-139-193-41-5-42-181-159-69-108-18-22-146-34-160-48-54-30-177-10-190-4-112-84-35-184-43-116-65-131-149-162-123-127-70-135-154-180-53-100-101-1-97-152-129-92-57-55-52-106-178"
133,72081,100,24305,96386,"193-139-68-46-115-118-59-51-0-117-143-183-89-186-23-137-176-80-79-63-94-124-152-97-1-101-2-120-129-55-49-102-148-9-62-144-14-178-106-165-90-81-196-40-119-185-52-57-92-179-145-78-31-56-113-175-171-16-25-44-75-86-26-100-53-154-180-70-135-133-151-162-127-123-149-131-65-116-43-184-84-112-4-190-10-177-54-48-160-34-146-22-18-108-69-159-181-42-5-41"
134,73918,100,24318,98236,"85-31-145-78-179-92-57-52-185-119-40-196-81-90-165-106-178-3-14-144-62-9-148-102-49-55-129-152-97-1-101-100-53-180-154-135-70-127-123-162-149-131-65-116-43-184-35-84-112-4-190-10-177-30-54-48-160-34-146-22-18-108-69-159-181-42-5-41-193-139-68-46-115-59-118-51-151-133-176-143-183-89-23-137-80-79-63-94-26-86-75-2-120-44-25-16-171-175-113-56"
135,72747,100,23227,95974,"27-39-165-138-14-144-62-9-148-102-49-178-106-52-55-57-92-129-152-97-1-101-100-53-180-154-135-70-127-123-162-149-131-65-116-43-184-35-84-112-4-190-10-177-30-54-48-160-34-146-22-18-108-69-159-181-42-5-41-193-139-68-46-115-59-118-51-151-133-176-183-89-23-137-80-79-63-94-26-86-75-2-120-44-25-16-171-175-113-56-31-78-145-179-185-119-40-196-81-90"
136,73768,100,23977,97745,"172-92-129-152-97-1-101-100-53-180-154-135-70-127-123-162-149-131-65-116-43-184-35-84-112-4-190-10-177-30-54-48-160-34-146-22-18-108-69-159-181-42-5-41-193-139-68-46-115-59-118-51-151-133-176-143-183-89-23-137-80-79-63-94-26-86-75-2-120-44-25-16-171-175-113-56-31-78-145-179-196-81-90-40-119-165-185-106-178-3-14-144-62-9-148-102-49-52-55-57"
137,71488,100,23578,95066,"117-0-46-68-139-193-41-115-5-42-181-159-69-108-18-22-146-34-160-48-54-30-177-10-190-4-112-84-35-184-43-116-65-59-118-51-151-133-162-123-127-70-135-180-154-53-100-26-86-75-44-25-16-171-175-113-56-31-78-145-179-92-57-52-185-119-40-196-81-90-165-106-178-14-144-62-9-148-102-49-55-129-120-2-101-1-97-152-124-94-63-79-80-176-137-23-186-89-183-143"
138,72179,100,23701,95880,"179-196-81-40-119-90-165-185-106-178-3-14-144-62-9-148-102-49-52-55-57-92-129-152-97-1-101-100-53-180-154-135-70-127-123-162-149-131-65-116-43-184-35-84-112-4-190-10-177-30-54-48-160-34-146-22-18-108-69-159-181-42-5-41-193-139-68-46-115-59-118-51-151-133-176-0-143-183-89-23-137-80-79-63-94-26-86-75-2-120-44-25-16-171-175-113-56-31-78-145"
139,72561,100,24404,96965,"72-51-0-117-143-183-89-186-23-137-176-80-79-63-94-124-152-97-1-101-2-120-129-55-49-102-148-9-62-144-14-178-106-165-90-81-196-40-119-185-52-57-92-179-145-78-31-56-113-175-171-16-25-44-75-86-26-100-53-154-180-70-135-133-151-162-127-123-149-131-65-116-43-184-84-112-190-10-177-54-48-160-34-146-22-18-108-69-159-181-42-5-41-193-139-68-46-115-118-59"
140,71948,100,23548,95496,"9-148-102-49-178-106-52-55-57-92-129-152-97-1-101-100-53-180-154-135-70-127-123-162-149-131-65-116-43-184-35-84-112-4-190-10-177-30-54-48-160-34-146-22-18-108-69-159-181-42-5-41-193-139-68-46-115-59-118-51-151-133-176-0-143-183-89-23-137-80-79-63-94-26-86-75-2-120-44-25-16-171-175-113-56-31-78-145-179-185-119-40-196-81-90-165-138-14-144-62"
141,73362,100,23502,96864,"74-1-101-2-120-129-57-92-179-145-78-31-56-113-175-171-16-25-44-75-86-53-154-70-135-180-63-79-133-51-118-59-115-46-68-139-193-41-5-42-181-159-69-108-18-22-146-34-160-48-54-177-10-190-4-112-84-184-43-116-65-131-149-123-127-162-151-80-176-137-23-183-89-186-15-9-62-144-14-138-165-90-81-196-40-119-185-55-52-106-178-49-102-148-124-94-100-26-97-152"
142,71987,100,23509,95496,"57-55-52-49-102-148-9-62-144-14-3-178-106-185-165-119-40-90-81-196-179-145-78-31-56-113-175-171-16-25-44-120-2-75-86-26-94-63-79-80-137-23-89-183-143-0-176-133-151-51-118-59-115-46-68-139-193-41-5-42-181-159-69-108-18-22-146-34-160-48-54-30-177-10-190-4-112-84-35-184-43-116-65-131-149-162-123-127-70-135-154-180-53-100-101-1-97-152-129-92"
143,71761,100,23851,95612,"84-4-112-127-123-162-151-133-135-70-180-154-53-100-26-86-75-44-25-16-171-175-113-56-31-78-145-179-92-57-52-185-119-40-196-81-90-165-106-178-14-144-62-9-148-102-49-55-129-120-2-101-1-97-152-124-94-63-79-80-176-137-23-186-89-183-143-117-0-51-118-59-65-116-43-42-5-115-46-68-139-41-193-159-69-108-18-22-146-181-34-160-48-54-30-177-10-190-184-35"
144,72022,100,24246,96268,"131-149-123-127-162-151-133-135-70-180-154-53-100-26-86-75-44-25-16-171-175-113-56-31-78-145-179-92-57-52-185-119-40-196-81-90-165-106-178-14-144-62-9-148-102-49-55-129-120-2-101-1-97-152-124-94-63-79-80-176-137-23-186-89-183-143-117-0-51-118-59-115-46-68-139-193-41-5-42-181-159-69-108-18-22-146-34-160-48-54-177-10-190-4-112-84-184-43-116-65"
145,73249,100,23629,96878,"174-119-40-185-179-145-78-31-56-113-175-171-16-25-44-120-2-75-86-26-94-63-79-80-137-23-89-183-143-176-133-151-51-118-59-115-46-68-139-193-41-5-42-181-159-69-108-18-22-146-34-160-48-54-30-177-10-190-4-112-84-35-184-43-116-65-131-149-162-123-127-70-135-154-180-53-100-101-1-97-152-129-92-57-55-52-106-178-49-102-148-9-62-144-14-138-165-90-81-196"
146,72081,100,24305,96386,"59-118-115-46-68-139-193-41-5-42-181-159-69-108-18-22-146-34-160-48-54-177-10-190-4-112-84-184-43-116-65-131-149-123-127-162-151-133-135-70-180-154-53-100-26-86-75-44-25-16-171-175-113-56-31-78-145-179-92-57-52-185-119-40-196-81-90-165-106-178-14-144-62-9-148-102-49-55-129-120-2-101-1-97-152-124-94-63-79-80-176-137-23-186-89-183-143-117-0-51"
147,71773,100,24102,95875,"181-146-22-18-108-69-159-193-41-139-68-46-115-118-59-51-0-117-143-183-89-186-23-137-176-80-79-63-94-124-152-97-1-101-2-120-129-55-49-102-148-9-62-144-14-178-106-165-90-81-196-40-119-185-52-57-92-179-145-78-31-56-113-175-171-16-25-44-75-86-26-100-53-154-180-70-135-133-151-162-127-123-149-131-65-116-43-42-184-35-84-112-4-190-10-177-54-48-160-34"
148,72671,100,23498,96169,"37-102-49-178-106-52-55-57-92-129-152-97-1-101-100-53-180-154-135-70-127-123-162-149-131-65-116-43-184-35-84-112-4-190-10-177-30-54-48-160-34-146-22-18-108-69-159-181-42-5-41-193-139-68-46-115-59-118-51-151-133-176-143-183-89-23-137-80-79-63-94-26-86-75-2-120-44-25-16-171-175-113-56-31-78-145-179-185-119-40-196-81-90-165-138-14-144-62-9-148"
149,73373,100,22852,96225,"95-7-164-27-90-81-196-40-119-185-179-145-78-31-56-113-175-171-16-25-44-120-2-75-86-26-94-63-79-80-137-176-133-151-51-118-59-115-46-68-139-193-41-5-42-181-159-69-108-18-22-146-34-160-48-54-30-177-10-190-4-112-84-35-184-43-116-65-131-149-162-123-127-70-135-154-180-53-100-101-1-97-152-129-92-57-55-52-106-178-49-102-148-9-62-144-14-138-165-39"
150,73043,100,24566,97609,"66-0-117-143-183-89-186-23-137-80-79-63-94-124-152-97-1-101-2-120-129-55-49-102-148-9-62-144-14-178-106-165-90-81-196-40-119-185-52-57-92-179-145-78-31-56-113-175-171-16-25-44-75-86-26-100-53-154-180-135-70-127-123-162-133-151-149-131-65-116-43-184-84-112-190-10-177-54-48-160-34-146-22-18-108-69-159-181-42-5-41-193-139-68-46-115-59-118-51-176"
151,73386,100,24271,97657,"82-2-75-86-26-94-63-79-80-137-23-89-183-143-176-133-151-51-118-59-115-46-68-139-193-41-5-42-181-159-69-108-18-22-146-34-160-48-54-30-177-10-190-4-112-84-35-184-43-116-65-131-149-162-123-127-70-135-154-180-53-100-101-1-97-152-129-55-49-102-148-9-62-144-14-3-178-106-165-90-81-196-40-119-185-52-57-92-179-145-78-31-56-113-175-171-16-25-44-120"
152,72087,100,24311,96398,"79-80-176-137-23-186-89-183-143-117-0-51-118-59-115-46-68-139-193-41-5-42-181-159-69-108-18-22-146-34-160-48-54-177-10-190-4-112-84-184-43-116-65-131-149-123-127-162-151-133-180-135-70-154-53-100-26-86-75-44-25-16-171-175-113-56-31-78-145-179-92-57-52-185-119-40-196-81-90-165-106-178-14-144-62-9-148-102-49-55-129-120-2-101-1-97-152-124-94-63"
153,71773,100,24102,95875,"160-48-54-177-10-190-4-112-84-35-184-42-43-116-65-131-149-123-127-162-151-133-135-70-180-154-53-100-26-86-75-44-25-16-171-175-113-56-31-78-145-179-92-57-52-185-119-40-196-81-90-165-106-178-14-144-62-9-148-102-49-55-129-120-2-101-1-97-152-124-94-63-79-80-176-137-23-186-89-183-143-117-0-51-59-118-115-46-68-139-41-193-159-69-108-18-22-146-181-34"
154,72752,100,23585,96337,"101-1-152-97-26-100-94-124-148-102-49-178-106-52-55-185-119-40-196-81-90-165-138-14-144-62-9-15-186-89-183-23-137-176-80-151-162-127-123-149-131-65-116-43-184-35-84-112-4-190-10-177-54-48-160-34-146-22-18-108-69-159-181-42-5-41-193-139-68-46-115-59-118-51-133-79-63-180-135-70-154-53-86-75-44-25-16-171-175-113-56-31-78-145-179-92-57-129-120-2"
155,72674,100,23389,96063,"121-100-26-86-75-44-25-16-171-175-113-56-31-78-145-179-92-57-129-120-2-101-1-97-152-94-124-148-102-49-178-106-52-55-185-119-40-196-81-90-165-138-14-144-62-9-15-186-89-183-23-137-176-80-151-162-127-123-149-131-65-116-43-184-84-112-4-190-10-177-54-48-160-34-146-22-18-108-69-159-181-42-5-41-193-139-68-46-115-59-118-51-133-79-63-180-135-70-154-53"
156,71948,100,23548,95496,"185-179-145-78-31-56-113-175-171-16-25-44-120-2-75-86-26-94-63-79-80-137-23-89-183-143-0-176-133-151-51-118-59-115-46-68-139-193-41-5-42-181-159-69-108-18-22-146-34-160-48-54-30-177-10-190-4-112-84-35-184-43-116-65-131-149-162-123-127-70-135-154-180-53-100-101-1-97-152-129-92-57-55-52-106-178-49-102-148-9-62-144-14-138-165-90-81-196-40-119"
157,72712,100,25041,97753,"177-54-48-34-160-181-42-43-116-41-193-159-146-22-18-108-69-139-68-46-115-118-59-65-131-149-151-51-0-117-143-183-89-186-23-137-176-80-79-63-94-124-152-97-1-101-2-120-129-55-49-102-148-9-62-144-14-178-106-165-90-81-196-40-119-185-52-57-92-179-145-78-31-56-113-175-171-16-25-44-75-86-26-100-53-154-180-70-135-133-162-123-127-112-4-84-35-184-190-10"
158,72326,100,23848,96174,"52-55-49-102-148-9-62-144-14-3-178-106-165-90-81-196-40-119-185-179-145-78-31-56-113-175-171-16-25-44-120-2-75-86-26-94-63-79-80-137-23-89-183-143-0-176-133-151-51-118-59-115-46-68-139-193-41-5-42-181-159-69-108-18-22-146-34-160-48-54-30-177-10-190-4-112-84-35-184-43-116-65-131-149-162-123-127-70-135-154-180-53-100-101-1-97-152-129-92-57"
159,74197,100,24494,98691,"122-137-23-89-183-176-80-79-151-162-127-123-149-131-65-116-43-184-35-84-112-4-190-10-177-30-54-48-160-34-146-22-18-108-69-159-181-42-5-41-193-139-68-46-115-59-118-51-133-180-135-70-154-53-100-26-86-75-44-25-16-171-175-113-56-31-78-145-179-92-57-52-185-119-40-196-81-90-165-106-178-3-14-144-62-9-148-102-49-55-129-120-2-101-1-97-152-124-94-63"
160,72845,100,24799,97644,"77-43-184-84-112-4-190-10-177-54-48-160-34-146-22-18-108-69-159-181-42-116-41-193-139-68-46-115-118-59-51-0-117-143-183-89-186-23-137-176-80-79-63-94-124-152-97-1-101-2-120-129-55-49-102-148-9-62-144-14-178-106-165-90-81-196-40-119-185-52-57-92-179-145-78-31-56-113-175-171-16-25-44-75-86-26-100-53-154-180-70-135-133-151-162-127-123-149-131-65"
161,74119,100,24298,98417,"13-31-145-78-179-92-57-52-185-119-40-196-81-90-165-106-178-3-14-144-62-9-148-102-49-55-129-152-97-1-101-100-53-180-154-135-70-127-123-162-149-131-65-116-43-184-35-84-112-4-190-10-177-30-54-48-160-34-146-22-18-108-69-159-181-42-5-41-193-139-68-46-115-59-118-51-151-133-176-143-183-89-23-137-80-79-63-94-26-86-75-2-120-44-25-16-171-175-113-56"
162,73362,100,23502,96864,"74-1-101-2-120-129-57-92-179-145-78-31-56-113-175-171-16-25-44-75-86-53-154-70-135-180-63-79-133-51-118-59-115-46-68-139-193-41-5-42-181-159-69-108-18-22-146-34-160-48-54-177-10-190-4-112-84-184-43-116-65-131-149-123-127-162-151-80-176-137-23-183-89-186-15-9-62-144-14-138-165-90-81-196-40-119-185-55-52-106-178-49-102-148-124-94-100-26-97-152"
163,72350,100,24104,96454,"198-46-115-118-59-51-0-117-143-183-89-186-23-137-176-80-79-63-94-124-152-97-1-101-2-120-129-55-49-102-148-9-62-144-14-178-106-165-90-81-196-40-119-185-52-57-92-179-145-78-31-56-113-175-171-16-25-44-75-86-26-100-53-154-180-70-135-133-151-162-127-123-149-131-65-116-43-184-84-112-4-190-10-177-54-48-160-34-146-22-18-108-69-159-181-42-5-41-193-139"
164,73176,100,24436,97612,"45-162-133-123-127-70-135-180-154-53-100-26-86-75-44-25-16-171-175-113-56-31-78-145-179-92-57-52-185-119-40-196-81-90-165-106-178-14-144-62-9-148-102-49-55-129-120-2-101-1-97-152-124-94-63-79-80-176-137-23-186-89-183-143-117-0-51-118-59-115-46-68-139-193-41-5-42-181-159-69-108-18-22-146-34-160-48-54-177-10-190-112-84-184-43-116-65-131-149-151"
165,71926,100,24150,96076,"18-22-146-159-193-41-5-42-181-34-160-48-54-177-10-190-4-112-84-184-43-116-65-131-149-123-127-162-151-133-135-70-180-154-53-100-26-86-75-44-25-16-171-175-113-56-31-78-145-179-92-57-52-185-119-40-196-81-90-165-106-178-14-144-62-9-148-102-49-55-129-120-2-101-1-97-152-124-94-63-79-80-176-137-23-186-89-183-143-117-0-51-59-118-115-46-68-139-69-108"
166,72129,100,24353,96482,"68-46-115-118-59-51-0-117-143-183-89-186-23-137-176-80-79-63-94-124-152-97-1-101-2-120-129-55-49-102-148-9-62-144-14-178-106-165-90-81-196-40-119-185-52-57-92-179-145-78-31-56-113-175-171-16-25-44-75-86-26-100-53-154-180-70-135-133-151-162-127-123-149-131-65-116-43-184-84-112-4-190-10-177-54-48-160-34-146-22-18-108-69-159-181-42-5-193-41-139"
167,73415,100,25081,98496,"11-35-84-4-112-127-123-162-133-135-70-180-154-53-100-26-86-75-44-25-16-171-175-113-56-31-78-145-179-92-57-52-185-40-196-81-90-165-106-178-14-144-62-9-148-102-49-55-129-120-2-101-1-97-152-124-94-63-79-80-176-137-23-186-89-183-143-117-0-51-151-149-131-65-59-118-115-46-68-139-193-41-116-43-42-181-159-69-108-18-22-146-34-160-48-54-177-10-190-184"
168,71951,100,24175,96126,"133-162-123-127-70-135-180-154-53-100-26-86-75-44-25-16-171-175-113-56-31-78-145-179-92-57-52-185-119-40-196-81-90-165-106-178-14-144-62-9-148-102-49-55-129-120-2-101-1-97-152-124-94-63-79-80-176-137-23-186-89-183-143-117-0-51-118-59-115-46-68-139-193-41-5-42-181-159-69-108-18-22-146-34-160-48-54-177-10-190-4-112-84-184-43-116-65-131-149-151"
169,72022,100,24246,96268,"131-149-123-127-162-151-133-135-70-180-154-53-100-26-86-75-44-25-16-171-175-113-56-31-78-145-179-92-57-52-185-119-40-196-81-90-165-106-178-14-144-62-9-148-102-49-55-129-120-2-101-1-97-152-124-94-63-79-80-176-137-23-186-89-183-143-117-0-51-118-59-115-46-68-139-193-41-5-42-181-159-69-108-18-22-146-34-160-48-54-177-10-190-4-112-84-184-43-116-65"
170,72834,100,24621,97455,"194-180-133-151-162-149-131-65-116-43-184-84-112-190-10-177-54-48-160-34-146-22-18-108-69-159-181-42-5-41-193-139-68-46-115-59-118-51-0-117-143-183-89-186-23-137-176-80-79-63-94-124-152-97-1-101-2-120-129-55-49-102-148-9-62-144-14-178-106-165-90-81-196-40-119-185-52-57-92-179-145-78-31-56-113-175-171-16-25-44-75-86-26-100-53-154-135-70-127-123"
171,72594,100,23799,96393,"15-144-14-138-165-90-81-196-40-119-185-179-145-78-31-56-113-175-171-16-25-44-120-2-75-86-26-94-63-79-80-137-23-89-183-143-176-133-151-51-118-59-115-46-68-139-193-41-5-42-181-159-69-108-18-22-146-34-160-48-54-30-177-10-190-4-112-84-35-184-43-116-65-131-149-162-123-127-70-135-154-180-53-100-101-1-97-152-129-92-57-55-52-106-178-49-102-62-9-148"
172,72081,100,24305,96386,"46-115-118-59-51-0-117-143-183-89-186-23-137-176-80-79-63-94-124-152-97-1-101-2-120-129-55-49-102-148-9-62-144-14-178-106-165-90-81-196-40-119-185-52-57-92-179-145-78-31-56-113-175-171-16-25-44-75-86-26-100-53-154-180-70-135-133-151-162-127-123-149-131-65-116-43-184-84-112-4-190-10-177-54-48-160-34-146-22-18-108-69-159-181-42-5-41-193-139-68"
173,74073,100,24235,98308,"168-145-179-92-57-52-185-119-40-196-81-90-165-106-178-3-14-144-62-9-148-102-49-55-129-152-97-1-101-100-53-180-154-135-70-127-123-162-149-131-65-116-43-184-35-84-112-4-190-10-177-30-54-48-160-34-146-22-18-108-69-159-181-42-5-41-193-139-68-46-115-59-118-51-151-133-176-143-183-89-23-137-80-79-63-94-26-86-75-2-120-44-25-16-171-175-113-56-31-78"
174,72747,100,23227,95974,"39-27-90-81-196-40-119-185-179-145-78-31-56-113-175-171-16-25-44-120-2-75-86-26-94-63-79-80-137-23-89-183-176-133-151-51-118-59-115-46-68-139-193-41-5-42-181-159-69-108-18-22-146-34-160-48-54-30-177-10-190-4-112-84-35-184-43-116-65-131-149-162-123-127-70-135-154-180-53-100-101-1-97-152-129-92-57-55-52-106-178-49-102-148-9-62-144-14-138-165"
175,72982,100,24264,97246,"141-51-118-59-115-46-68-139-193-41-5-42-181-159-69-108-18-22-146-34-160-48-54-177-10-190-112-84-184-43-116-65-131-149-123-127-162-151-133-135-70-180-154-53-100-26-86-75-44-25-16-171-175-113-56-31-78-145-179-92-57-52-185-119-40-196-81-90-165-106-178-14-144-62-9-148-102-49-55-129-120-2-101-1-97-152-124-94-63-79-80-176-137-23-186-89-183-143-117-0"
176,72813,100,23396,96209,"189-152-97-1-101-2-120-129-57-92-179-145-78-31-56-113-175-171-16-25-44-75-86-26-100-53-154-70-135-180-63-79-133-51-118-59-115-46-68-139-193-41-5-42-181-159-69-108-18-22-146-34-160-48-54-177-10-190-4-112-84-184-43-116-65-131-149-123-127-162-151-80-176-137-23-183-89-186-15-9-62-144-14-138-165-90-81-196-40-119-185-55-52-106-178-49-102-148-124-94"
177,73436,100,24039,97475,"128-167-148-9-62-102-144-14-49-178-106-165-90-81-196-40-119-185-52-55-57-179-145-78-31-56-113-175-171-16-25-44-120-2-75-86-26-94-63-79-80-137-23-89-183-143-176-133-151-51-118-59-115-46-68-139-193-41-5-42-181-159-69-108-18-22-146-34-160-48-54-30-177-10-190-4-112-84-35-184-43-116-65-131-149-162-123-127-70-135-154-180-53-100-101-1-97-152-129-92"
178,72985,100,24475,97460,"197-116-65-59-118-51-0-117-143-183-89-186-23-137-176-80-79-63-94-124-152-97-1-101-2-120-129-55-49-102-148-9-62-144-14-178-106-165-90-81-196-40-119-185-52-57-92-179-145-78-31-56-113-175-171-16-25-44-75-86-26-100-53-154-180-70-135-133-151-162-127-123-149-131-43-184-84-112-190-10-177-54-48-160-34-146-22-18-108-69-159-181-42-5-41-193-139-68-46-115"
179,72602,100,23435,96037,"94-152-97-1-101-2-120-129-57-92-179-145-78-31-56-113-175-171-16-25-44-75-86-26-100-53-154-70-135-180-63-79-133-51-118-59-115-46-68-139-193-41-5-42-181-159-69-108-18-22-146-34-160-48-54-177-10-190-4-112-84-35-184-43-116-65-131-149-123-127-162-151-80-176-137-23-183-89-186-15-9-62-144-14-138-165-90-81-196-40-119-185-55-52-106-178-49-102-148-124"
180,72129,100,24353,96482,"68-46-115-118-59-51-0-117-143-183-89-186-23-137-176-80-79-63-94-124-152-97-1-101-2-120-129-55-49-102-148-9-62-144-14-178-106-165-90-81-196-40-119-185-52-57-92-179-145-78-31-56-113-175-171-16-25-44-75-86-26-100-53-154-180-70-135-133-151-162-127-123-149-131-65-116-43-184-84-112-4-190-10-177-54-48-160-34-146-22-18-108-69-159-181-42-5-193-41-139"
181,72639,100,24161,96800,"78-31-56-113-175-171-16-25-44-120-2-75-86-26-94-63-79-80-137-23-89-183-143-0-176-133-151-51-118-59-115-46-68-139-193-41-5-42-181-159-69-108-18-22-146-34-160-48-54-30-177-10-190-4-112-84-35-184-43-116-65-131-149-162-123-127-70-135-154-180-53-100-101-1-97-152-129-55-49-102-148-9-62-144-14-3-178-106-165-90-81-196-40-119-185-52-57-92-179-145"
182,74119,100,24298,98417,"13-31-145-78-179-92-57-52-185-119-40-196-81-90-165-106-178-3-14-144-62-9-148-102-49-55-129-152-97-1-101-100-53-180-154-135-70-127-123-162-149-131-65-116-43-184-35-84-112-4-190-10-177-30-54-48-160-34-146-22-18-108-69-159-181-42-5-41-193-139-68-46-115-59-118-51-151-133-176-143-183-89-23-137-80-79-63-94-26-86-75-2-120-44-25-16-171-175-113-56"
183,71761,100,23851,95612,"4-84-35-184-190-10-177-30-54-48-160-34-181-146-22-18-108-69-159-193-41-139-68-46-115-5-42-43-116-65-59-118-51-0-117-143-183-89-186-23-137-176-80-79-63-94-124-152-97-1-101-2-120-129-55-49-102-148-9-62-144-14-178-106-165-90-81-196-40-119-185-52-57-92-179-145-78-31-56-113-175-171-16-25-44-75-86-26-100-53-154-180-70-135-133-151-162-123-127-112"
184,72211,100,24435,96646,"162-133-123-127-70-135-180-154-53-100-26-86-75-44-25-16-171-175-113-56-31-78-145-179-92-57-52-185-119-40-196-81-90-165-106-178-14-144-62-9-148-102-49-55-129-120-2-101-1-97-152-124-94-63-79-80-176-137-23-186-89-183-143-117-0-51-118-59-115-46-68-139-193-41-5-42-181-159-69-108-18-22-146-34-160-48-54-177-10-190-4-112-84-184-43-116-65-131-149-151"
185,71773,100,24102,95875,"181-146-22-18-108-69-159-193-41-139-68-46-115-118-59-51-0-117-143-183-89-186-23-137-176-80-79-63-94-124-152-97-1-101-2-120-129-55-49-102-148-9-62-144-14-178-106-165-90-81-196-40-119-185-52-57-92-179-145-78-31-56-113-175-171-16-25-44-75-86-26-100-53-154-180-70-135-133-151-162-127-123-149-131-65-116-43-42-184-35-84-112-4-190-10-177-54-48-160-34"
186,71948,100,23548,95496,"49-102-148-9-62-144-14-138-165-90-81-196-40-119-185-179-145-78-31-56-113-175-171-16-25-44-120-2-75-86-26-94-63-79-80-137-23-89-183-143-0-176-133-151-51-118-59-115-46-68-139-193-41-5-42-181-159-69-108-18-22-146-34-160-48-54-30-177-10-190-4-112-84-35-184-43-116-65-131-149-162-123-127-70-135-154-180-53-100-101-1-97-152-129-92-57-55-52-106-178"
187,73152,100,24408,97560,"142-139-68-46-115-118-59-51-0-117-143-183-89-186-23-137-176-80-79-63-94-124-152-97-1-101-2-120-129-55-49-102-148-9-62-144-14-178-106-165-90-81-196-40-119-185-52-57-92-179-145-78-31-56-113-175-171-16-25-44-75-86-26-100-53-154-180-70-135-133-151-162-127-123-149-131-65-116-43-184-84-112-190-10-177-54-48-160-34-146-22-18-108-69-159-181-42-5-41-193"
188,71958,100,24060,96018,"103-34-181-160-48-54-177-10-190-4-112-84-184-42-43-116-65-131-149-123-127-162-151-133-135-70-180-154-53-100-26-86-75-44-25-16-171-175-113-56-31-78-145-179-92-57-52-185-119-40-196-81-90-165-106-178-14-144-62-9-148-102-49-55-129-120-2-101-1-97-152-124-94-63-79-80-176-137-23-186-89-183-143-117-0-51-59-118-115-46-68-139-41-193-159-69-108-18-22-146"
189,71948,100,23548,95496,"49-102-148-9-62-144-14-138-165-90-81-196-40-119-185-179-145-78-31-56-113-175-171-16-25-44-120-2-75-86-26-94-63-79-80-137-23-89-183-143-0-176-133-151-51-118-59-115-46-68-139-193-41-5-42-181-159-69-108-18-22-146-34-160-48-54-30-177-10-190-4-112-84-35-184-43-116-65-131-149-162-123-127-70-135-154-180-53-100-101-1-97-152-129-92-57-55-52-106-178"
190,72484,100,24033,96517,"109-118-46-115-139-193-41-5-42-181-159-69-108-18-22-146-34-160-48-54-30-177-10-190-4-112-84-35-184-43-65-116-59-151-133-162-123-127-70-135-180-154-53-100-26-86-75-44-25-16-171-175-113-56-31-78-145-179-92-57-52-185-119-40-196-81-90-165-106-178-14-144-62-9-148-102-49-55-129-120-2-101-1-97-152-124-94-63-79-80-176-137-23-186-89-183-143-117-0-51"
191,72834,100,24621,97455,"194-180-133-151-162-149-131-65-116-43-184-84-112-190-10-177-54-48-160-34-146-22-18-108-69-159-181-42-5-41-193-139-68-46-115-59-118-51-0-117-143-183-89-186-23-137-176-80-79-63-94-124-152-97-1-101-2-120-129-55-49-102-148-9-62-144-14-178-106-165-90-81-196-40-119-185-52-57-92-179-145-78-31-56-113-175-171-16-25-44-75-86-26-100-53-154-135-70-127-123"
192,72081,100,24305,96386,"118-115-46-68-139-193-41-5-42-181-159-69-108-18-22-146-34-160-48-54-177-10-190-4-112-84-184-43-116-65-131-149-123-127-162-151-133-135-70-180-154-53-100-26-86-75-44-25-16-171-175-113-56-31-78-145-179-92-57-52-185-119-40-196-81-90-165-106-178-14-144-62-9-148-102-49-55-129-120-2-101-1-97-152-124-94-63-79-80-176-137-23-186-89-183-143-117-0-51-59"
193,74197,100,24494,98691,"122-137-23-89-183-176-80-79-151-162-127-123-149-131-65-116-43-184-35-84-112-4-190-10-177-30-54-48-160-34-146-22-18-108-69-159-181-42-5-41-193-139-68-46-115-59-118-51-133-180-135-70-154-53-100-26-86-75-44-25-16-171-175-113-56-31-78-145-179-92-57-52-185-119-40-196-81-90-165-106-178-3-14-144-62-9-148-102-49-55-129-120-2-101-1-97-152-124-94-63"
194,74073,100,24235,98308,"168-145-179-92-57-52-185-119-40-196-81-90-165-106-178-3-14-144-62-9-148-102-49-55-129-152-97-1-101-100-53-180-154-135-70-127-123-162-149-131-65-116-43-184-35-84-112-4-190-10-177-30-54-48-160-34-146-22-18-108-69-159-181-42-5-41-193-139-68-46-115-59-118-51-151-133-176-143-183-89-23-137-80-79-63-94-26-86-75-2-120-44-25-16-171-175-113-56-31-78"
195,72507,100,24123,96630,"192-181-146-22-18-108-69-159-193-41-139-68-46-115-118-59-51-0-117-143-183-89-186-23-137-176-80-79-63-94-124-152-97-1-101-2-120-129-55-49-102-148-9-62-144-14-178-106-165-90-81-196-40-119-185-52-57-92-179-145-78-31-56-113-175-171-16-25-44-75-86-26-100-53-154-180-70-135-133-151-162-127-123-149-131-65-116-43-42-184-84-112-4-190-10-177-54-48-160-34"
196,72081,100,24305,96386,"116-43-184-84-112-4-190-10-177-54-48-160-34-146-22-18-108-69-159-181-42-5-41-193-139-68-46-115-118-59-51-0-117-143-183-89-186-23-137-176-80-79-63-94-124-152-97-1-101-2-120-129-55-49-102-148-9-62-144-14-178-106-165-90-81-196-40-119-185-52-57-92-179-145-78-31-56-113-175-171-16-25-44-75-86-26-100-53-154-180-70-135-133-151-162-127-123-149-131-65"
197,74197,100,24494,98691,"122-137-23-89-183-176-80-79-151-162-127-123-149-131-65-116-43-184-35-84-112-4-190-10-177-30-54-48-160-34-146-22-18-108-69-159-181-42-5-41-193-139-68-46-115-59-118-51-133-180-135-70-154-53-100-26-86-75-44-25-16-171-175-113-56-31-78-145-179-92-57-52-185-119-40-196-81-90-165-106-178-3-14-144-62-9-148-102-49-55-129-120-2-101-1-97-152-124-94-63"
198,73475,100,23576,97051,"61-144-14-138-165-90-81-196-40-119-185-179-145-78-31-56-113-175-171-16-25-44-120-2-75-86-26-94-63-79-80-137-23-89-183-143-176-133-151-51-118-59-115-46-68-139-193-41-5-42-181-159-69-108-18-22-146-34-160-48-54-30-177-10-190-4-112-84-35-184-43-116-65-131-149-162-123-127-70-135-154-180-53-100-101-1-97-152-129-92-57-55-52-106-178-49-102-148-62-9"
199,72835,100,24148,96983,"182-121-100-26-86-75-44-25-16-171-175-113-56-31-78-145-179-92-57-52-185-119-40-196-81-90-165-106-178-14-144-62-9-148-102-49-55-129-120-2-101-1-97-152-124-94-63-79-80-176-137-23-186-89-183-143-117-0-51-118-59-115-46-68-139-193-41-5-42-181-159-69-108-18-22-146-34-160-48-54-177-10-190-84-184-43-116-65-131-149-123-127-162-151-133-180-135-70-154-53"
200,72087,100,24311,96398,"53-154-70-135-180-133-151-162-127-123-149-131-65-116-43-184-84-112-4-190-10-177-54-48-160-34-146-22-18-108-69-159-181-42-5-41-193-139-68-46-115-59-118-51-0-117-143-183-89-186-23-137-176-80-79-63-94-124-152-97-1-101-2-120-129-55-49-102-148-9-62-144-14-178-106-165-90-81-196-40-119-185-52-57-92-179-145-78-31-56-113-175-171-16-25-44-75-86-26-100"
