SolutionID,TotalCost,NumNodes,TotalDistance,ObjectiveFunction,TotalRunningTime,Cycle
1,99663,100,49284,148947,72,"72-118-51-176-80-63-121-26-100-180-43-42-34-160-184-97-2-82-78-92-57-55-129-152-101-75-120-44-31-25-115-18-22-193-159-41-139-46-183-89-165-40-90-21-144-9-137-59-116-65-47-127-70-53-52-106-179-145-135-177-10-4-112-154-167-148-15-114-186-23-0-117-170-143-62-14-178-49-3-185-196-81-124-94-162-24-131-149-35-84-123-86-16-171-113-175-1-79-133-151"
2,90955,100,41637,132592,23,"9-62-102-49-167-124-26-100-86-53-154-180-136-182-63-94-176-0-117-143-183-89-23-44-120-92-57-2-152-1-97-101-75-55-106-138-14-144-51-118-160-177-54-48-34-181-159-41-116-123-162-79-80-59-65-43-42-139-115-151-121-78-145-196-185-179-25-175-171-16-135-133-46-68-18-22-193-5-131-149-184-35-4-84-112-70-129-31-56-113-81-165-90-40-52-178-148-137-186-15"
3,92268,100,43043,135311,31,"81-90-165-40-185-106-178-148-51-151-79-94-100-26-101-1-137-0-93-140-18-108-46-186-62-49-144-183-143-117-68-139-198-193-181-34-160-54-48-42-5-116-47-162-135-70-127-35-131-149-124-57-179-145-92-129-55-52-14-9-15-23-115-65-154-180-44-25-78-2-121-53-158-63-43-146-22-159-41-118-72-59-176-80-133-123-112-4-177-184-152-120-75-86-97-16-171-175-113-31"
4,86928,100,39442,126370,19,"89-21-7-164-14-144-186-23-117-93-108-69-18-22-34-160-54-48-184-35-43-47-65-116-115-148-178-52-16-171-175-113-31-106-49-62-9-167-100-26-97-2-129-92-78-145-1-86-101-75-44-120-152-53-133-151-149-42-181-146-159-41-193-139-131-127-70-135-59-118-51-137-176-80-162-123-84-177-10-4-112-154-180-94-57-179-196-81-90-27-165-40-185-55-63-79-46-0-143-183"
5,90192,100,40582,130774,32,"44-25-78-196-81-90-165-14-62-186-89-183-143-170-117-68-139-108-18-22-34-160-159-46-0-51-151-72-59-118-116-65-131-149-94-152-97-129-106-102-9-43-42-5-148-167-124-122-80-176-133-162-54-177-181-193-41-115-137-15-144-49-178-185-119-40-52-55-179-57-75-121-158-53-26-100-101-1-2-82-56-113-175-171-16-31-145-92-86-127-123-112-184-79-63-180-154-135-70-120"
6,94117,100,44143,138260,27,"14-144-89-183-117-108-18-68-23-9-62-178-106-52-145-56-113-175-157-81-196-179-92-129-2-1-75-44-120-86-158-70-135-154-127-123-177-54-160-48-34-116-47-5-193-139-42-59-51-133-122-180-53-16-171-31-185-49-102-148-37-124-111-167-55-57-82-152-26-151-149-184-84-4-112-162-63-94-137-143-0-46-41-159-22-181-43-176-80-97-101-100-118-115-65-79-78-165-40-90"
7,88720,100,38015,126735,30,"44-25-16-171-175-113-31-78-145-92-129-57-55-167-46-139-193-41-96-43-5-42-184-48-54-177-10-112-4-84-35-51-148-62-9-94-189-97-124-143-117-108-18-159-115-0-183-89-49-3-178-52-106-144-14-138-90-165-185-40-2-101-75-1-152-65-47-34-160-146-22-195-181-116-131-149-162-180-86-26-100-53-59-109-72-118-151-176-137-186-23-80-79-63-133-123-127-135-154-120"
8,91093,100,42032,133125,23,"171-16-44-75-47-116-65-115-198-46-117-143-144-14-165-119-40-185-1-97-121-70-127-112-4-84-184-160-131-149-158-86-101-53-154-123-43-42-181-34-54-177-35-94-152-120-25-57-55-183-0-68-139-193-108-18-146-22-159-41-118-162-135-180-63-79-80-176-133-100-26-2-92-129-167-124-51-59-72-151-137-23-89-186-148-62-90-81-196-31-78-52-178-106-49-102-179-145-175-113"
9,89175,100,38757,127932,14,"127-123-35-131-149-47-5-42-181-41-193-159-22-146-34-48-160-43-59-167-178-179-145-78-44-25-57-55-138-14-49-102-9-62-148-46-139-108-18-54-184-177-4-112-151-51-109-176-94-124-92-129-82-101-97-121-53-154-70-135-180-158-75-2-1-63-137-0-143-183-144-3-106-52-133-162-65-116-115-118-79-80-122-86-120-16-171-175-113-56-31-196-165-40-90-81-185-152-26-100"
10,92783,100,43910,136693,23,"18-139-149-123-70-86-1-152-102-14-144-114-23-137-176-80-79-63-94-2-129-120-44-25-78-92-89-183-0-143-46-118-151-121-26-100-180-162-65-47-181-34-160-54-30-190-10-177-184-59-51-186-15-62-9-49-55-52-57-101-75-16-31-175-113-171-127-112-35-43-116-42-5-96-41-193-159-22-146-115-145-196-165-90-178-124-133-135-154-53-97-185-40-119-106-167-148-117-93-108"
11,95161,100,44622,139783,15,"62-15-186-23-137-46-68-18-108-93-176-2-145-92-78-31-171-175-113-56-81-90-27-165-138-49-102-9-148-94-152-1-97-70-194-127-123-34-193-41-117-143-0-153-183-89-53-158-121-106-55-52-75-86-25-44-16-40-119-185-162-184-43-65-100-26-101-120-129-167-122-59-51-149-131-116-151-133-135-154-180-79-63-80-118-115-139-159-22-181-160-42-124-57-179-196-178-3-14-144"
12,91449,100,42035,133484,16,"49-102-62-9-186-143-117-46-139-41-193-115-43-160-34-54-177-70-180-133-94-55-40-119-185-196-90-81-78-25-120-2-101-100-53-154-162-0-183-89-23-122-63-121-26-1-75-171-175-16-31-113-106-178-189-97-152-44-179-145-124-51-118-59-47-65-149-131-181-146-159-18-22-42-151-79-80-137-15-144-138-165-14-167-148-176-116-184-84-112-123-127-135-86-82-92-57-129-52-3"
13,88319,100,38450,126769,15,"117-143-183-89-21-7-164-27-90-39-57-180-154-63-94-122-79-80-151-133-101-97-1-75-2-129-92-185-40-119-165-152-26-86-70-135-162-176-51-115-193-41-139-46-137-23-186-144-3-178-106-31-56-113-78-25-157-81-196-179-52-55-145-171-175-16-44-120-100-121-53-124-167-138-14-37-148-15-62-102-49-9-59-43-65-123-116-42-181-34-54-184-177-4-112-160-22-18-69-108"
14,98632,100,45285,143917,17,"138-21-164-90-165-57-2-75-133-151-51-116-42-43-47-65-34-160-184-112-162-92-179-196-81-157-31-25-120-70-127-149-131-79-121-1-101-86-100-26-97-148-37-102-106-185-119-40-169-171-175-145-78-129-124-80-115-41-193-59-152-44-16-56-113-82-167-15-144-14-62-49-3-52-55-139-46-117-143-0-183-186-114-23-89-118-123-135-154-63-94-189-122-176-53-158-180-137-9-178"
15,97615,100,48518,146133,17,"151-65-47-162-154-75-120-44-145-78-16-171-175-113-185-106-62-9-15-23-137-97-101-86-123-160-181-41-139-80-124-52-178-176-109-118-115-116-131-149-112-70-100-1-2-57-196-31-179-117-0-143-89-183-43-184-54-177-48-34-146-22-18-108-159-42-35-127-135-63-148-102-49-165-27-90-40-14-93-68-193-46-59-51-186-114-144-167-152-26-53-180-158-121-55-92-129-94-79-133"
16,93292,100,40234,133526,40,"164-90-165-119-40-106-178-3-49-37-111-1-101-16-171-175-113-56-31-196-185-52-55-97-26-100-53-121-63-79-194-127-158-180-135-70-112-184-35-154-86-75-25-44-145-179-23-186-15-144-14-138-102-148-176-51-115-139-46-68-0-143-183-89-137-80-182-152-129-78-57-92-120-82-2-151-59-65-42-160-123-133-122-94-189-124-167-9-62-162-131-149-116-43-41-193-22-18-117-21"
17,91403,100,42439,133842,18,"154-165-40-185-120-70-112-184-10-177-54-48-160-116-47-65-131-149-123-135-94-148-62-9-124-79-133-151-51-59-115-41-193-159-181-5-43-42-118-162-180-1-152-75-101-97-86-100-26-53-121-63-80-176-143-0-23-186-15-102-3-57-129-92-49-144-14-138-90-81-31-157-106-178-89-183-137-2-44-25-78-145-179-52-55-16-175-171-113-56-196-139-46-68-108-69-18-22-34-127"
18,90809,100,42153,132962,21,"165-164-7-21-144-102-49-52-92-120-44-16-171-175-113-31-25-2-177-54-48-34-146-22-159-41-75-78-145-40-90-81-196-185-179-57-53-154-180-158-135-70-127-123-131-42-65-116-162-151-72-59-68-36-140-93-108-18-139-118-51-176-148-97-1-101-86-26-100-117-0-143-183-89-46-193-160-43-115-80-63-79-133-112-184-35-149-137-15-62-9-178-3-106-55-129-152-94-124-14"
19,90354,100,42651,133005,45,"115-116-59-118-151-152-129-92-167-80-65-54-177-10-4-127-123-35-149-131-135-180-53-121-100-2-57-55-102-49-178-52-120-44-16-40-119-165-164-7-21-144-15-137-94-101-75-31-113-175-171-185-14-9-62-148-176-51-46-68-0-183-23-186-106-39-90-81-196-179-78-145-154-70-112-84-184-43-42-181-22-18-108-117-143-89-124-97-26-1-86-63-79-133-162-160-34-41-193-139"
20,96091,100,45068,141159,23,"86-75-129-57-92-2-1-101-100-26-97-189-124-152-70-127-194-133-79-106-185-40-165-52-176-51-115-96-193-41-72-63-53-158-35-184-181-22-159-137-62-144-9-148-94-18-108-93-117-143-80-151-162-149-131-84-112-4-10-177-54-160-34-23-89-183-49-102-14-178-55-145-120-44-25-78-16-171-175-113-31-179-0-139-68-46-43-47-59-5-42-154-180-135-123-65-116-118-122-121"
21,101333,100,52754,154087,21,"112-123-127-70-135-154-79-0-117-93-108-18-139-59-46-118-65-116-51-21-164-27-90-14-43-160-22-159-80-124-106-178-40-119-157-56-196-145-179-78-25-16-44-26-180-53-158-120-129-137-186-23-143-183-89-62-15-144-49-102-9-148-68-115-184-54-34-42-193-41-82-31-2-75-86-101-121-152-94-100-1-57-92-52-55-167-176-133-151-97-175-171-113-81-185-165-63-162-149-131"
22,94776,100,43779,138555,23,"160-48-54-184-123-127-70-120-25-16-171-78-185-40-165-14-49-152-86-135-112-4-10-177-34-193-22-18-159-41-121-101-44-31-56-113-175-145-179-94-122-63-79-80-124-176-151-46-117-143-114-92-55-148-137-118-59-154-1-3-106-52-178-57-129-2-75-26-100-97-167-102-15-186-23-51-12-37-9-62-144-89-183-0-68-139-198-115-133-162-53-180-149-131-116-47-65-43-42-181"
23,89634,100,40356,129990,29,"79-63-121-26-100-185-40-81-196-31-16-44-92-55-106-178-15-186-183-89-151-180-75-120-25-129-2-1-189-133-116-5-115-51-152-57-145-78-171-175-113-179-52-49-9-62-167-124-53-135-70-127-34-146-18-108-22-181-160-48-54-177-159-193-41-42-43-65-184-112-84-35-149-123-131-139-46-0-143-117-118-59-162-154-158-86-101-97-19-94-148-144-165-90-138-14-102-137-176-80"
24,88514,100,38926,127440,23,"175-171-16-44-75-101-133-151-72-51-137-15-102-49-3-178-106-152-70-135-154-94-14-144-62-186-89-183-153-143-117-159-22-146-34-160-42-43-47-65-115-139-108-140-68-46-118-162-180-53-25-78-145-129-2-92-55-40-90-81-196-185-165-138-9-148-59-149-116-5-41-193-199-69-18-93-0-23-63-79-80-176-131-184-54-10-177-112-123-86-100-97-26-1-120-57-52-31-56-113"
25,93437,100,44835,138272,30,"37-102-14-165-90-27-164-21-186-137-59-43-184-112-127-194-123-149-42-160-34-54-177-63-44-25-16-171-175-106-49-23-143-0-117-183-89-62-178-3-78-113-31-2-1-101-100-121-26-97-152-167-52-55-185-179-196-81-119-40-145-92-57-129-75-120-86-18-159-22-146-181-135-70-180-53-154-133-162-116-65-115-139-68-118-176-124-94-122-79-193-41-46-51-151-80-15-144-9-148"
26,98582,100,46882,145464,36,"78-145-179-42-22-159-193-41-181-34-54-160-43-116-47-65-149-2-129-92-82-44-120-75-100-121-189-97-1-101-122-118-59-51-162-72-133-154-180-135-35-184-112-53-171-175-113-56-157-81-196-14-106-3-178-62-102-49-124-63-176-148-9-186-137-0-89-73-144-114-23-143-117-183-40-27-90-119-55-94-80-151-123-127-70-26-152-57-52-185-165-15-46-139-115-79-86-25-16-31"
27,86691,100,36325,123016,28,"49-14-144-186-23-0-68-139-41-181-160-54-177-184-35-116-59-51-80-122-79-133-180-154-53-86-100-26-97-94-63-151-162-65-149-127-135-124-148-52-106-165-185-92-44-25-113-56-178-3-55-129-152-1-101-75-2-16-171-175-31-157-78-145-57-40-90-81-196-179-120-70-112-84-4-123-176-89-183-143-117-46-198-115-96-43-47-42-5-195-146-34-22-159-193-118-137-62-9-102"
28,103547,100,55016,158563,14,"118-46-68-0-144-14-165-185-40-90-164-21-102-94-43-35-112-127-70-86-2-111-148-137-193-22-159-69-18-108-117-143-31-113-16-120-135-4-54-160-116-59-97-1-75-101-180-53-151-51-176-133-124-82-179-57-92-145-78-25-44-26-149-65-41-181-34-139-23-186-89-183-162-154-100-152-167-106-55-123-84-177-184-42-115-114-15-62-129-171-175-196-52-178-49-9-37-80-79-63"
29,90020,100,39310,129330,27,"143-183-89-21-164-27-90-16-171-175-113-56-31-81-14-144-102-62-186-23-137-51-41-22-159-116-131-127-135-154-158-97-101-86-75-120-157-196-179-82-1-180-79-63-53-100-26-121-152-129-92-178-49-52-55-106-40-165-185-57-25-44-145-78-2-70-112-84-160-43-42-5-115-46-118-65-149-123-162-59-176-80-94-189-19-167-9-148-124-133-151-181-34-54-10-190-177-184-193-139"
30,102114,100,49213,151327,17,"129-160-48-54-84-127-70-154-53-23-89-139-96-5-115-109-51-180-158-194-162-116-149-131-72-176-148-9-102-106-138-14-178-52-55-101-86-4-177-184-77-43-198-46-2-171-175-113-31-16-75-100-26-133-151-118-159-193-41-68-117-143-0-183-165-40-196-25-44-92-185-49-97-152-1-135-123-112-35-47-65-59-80-79-63-122-124-62-144-137-22-34-181-42-94-120-78-145-179-57"
31,93766,100,43941,137707,20,"59-118-51-15-186-23-137-117-68-46-0-143-183-89-114-9-102-26-1-120-129-92-78-31-157-81-196-145-55-115-181-34-54-177-123-149-47-116-42-43-131-97-57-179-40-185-165-90-44-101-53-158-154-180-63-122-79-152-52-106-167-124-94-148-49-178-3-14-144-62-135-127-70-86-75-100-176-139-18-22-146-159-41-193-96-5-160-184-65-162-133-121-16-171-113-175-25-2-80-151"
32,93120,100,43090,136210,14,"117-46-139-42-181-34-146-22-193-41-115-80-94-82-25-78-129-162-59-151-63-79-133-135-127-123-112-131-149-65-118-51-176-144-14-21-164-90-152-86-158-53-26-100-121-124-148-37-114-23-137-15-9-62-167-154-70-4-177-54-48-160-184-43-116-180-189-179-92-178-102-183-89-186-52-31-113-175-171-16-44-101-1-97-120-75-2-145-196-81-185-57-55-40-165-106-49-0-170-143"
33,91783,100,41526,133309,14,"114-15-9-148-124-79-59-5-42-181-160-131-65-162-133-136-121-94-97-26-101-1-75-86-100-53-154-180-176-137-89-23-183-117-22-34-54-177-184-116-159-139-18-108-143-178-179-78-25-120-70-135-123-149-47-43-115-46-198-41-193-68-0-109-51-118-151-152-167-55-165-119-106-52-92-16-44-49-102-62-144-14-185-196-81-90-40-31-113-171-175-56-145-129-57-2-63-80-122-186"
34,88245,100,39363,127608,17,"25-31-113-175-171-16-44-120-2-118-115-193-159-18-108-69-41-5-160-48-54-177-4-127-135-70-26-1-92-81-90-40-52-55-57-152-63-79-59-151-133-180-53-94-137-153-183-89-23-186-176-80-51-139-22-146-34-181-42-116-43-65-149-112-84-184-35-123-162-154-143-117-68-46-0-114-102-138-165-144-148-9-62-15-37-167-78-145-179-185-14-49-3-106-178-129-75-86-97-101"
35,95236,100,46624,141860,17,"42-43-118-23-186-124-26-97-152-167-49-102-62-9-15-144-14-148-176-51-122-63-80-79-133-151-137-89-183-21-164-90-165-185-81-57-179-196-157-78-75-184-54-177-112-135-1-129-145-92-52-55-94-162-193-159-22-41-5-115-139-68-0-143-117-108-18-46-180-86-2-44-25-101-100-59-65-47-116-149-123-70-154-158-53-178-106-119-40-16-171-56-113-175-31-82-120-127-160-34"
36,92581,100,43766,136347,24,"177-184-116-65-152-2-106-21-7-164-90-145-120-44-16-171-175-113-92-57-55-52-167-162-123-127-70-154-53-1-101-86-121-63-51-117-143-89-183-144-14-165-119-40-185-49-148-118-115-41-193-198-46-0-23-186-62-9-15-137-176-133-180-100-26-97-94-124-129-82-78-31-25-75-135-42-160-48-34-195-159-139-80-179-196-81-3-178-79-151-59-68-140-93-108-18-22-146-181-54"
37,89457,100,40111,129568,17,"165-119-40-185-52-55-31-113-175-171-16-75-86-158-135-154-80-63-129-92-2-101-100-53-127-112-84-43-47-116-178-106-7-164-90-81-196-157-179-145-78-25-44-120-57-193-139-115-65-42-181-159-41-18-22-146-34-160-54-177-70-180-121-26-97-1-152-167-62-9-148-176-51-109-118-59-137-23-15-14-144-186-89-183-143-0-46-68-162-151-72-149-131-184-35-123-133-79-94-49"
38,85419,100,37121,122540,26,"118-59-115-46-139-22-146-34-54-177-10-4-112-127-70-123-135-154-180-53-100-121-26-97-2-129-57-101-75-120-25-196-81-40-185-138-144-148-37-15-9-62-102-49-106-52-92-78-16-171-175-145-55-3-178-167-63-133-151-68-140-108-18-159-193-41-5-42-116-43-184-160-181-65-162-44-31-56-113-90-165-164-21-14-1-86-94-79-122-152-124-137-183-89-143-117-0-176-80-51"
39,98478,100,49523,148001,34,"15-186-23-114-144-31-113-175-171-16-44-120-9-62-148-124-94-80-79-135-180-154-158-152-1-97-131-43-160-34-18-108-65-162-151-133-59-42-159-193-139-14-165-90-40-55-52-57-112-4-54-48-116-176-137-183-0-117-93-140-118-53-63-89-143-51-149-184-22-146-181-41-115-68-46-121-100-26-136-127-123-190-10-177-70-75-92-129-78-145-179-185-106-178-3-49-167-2-86-101"
40,91885,100,42015,133900,50,"186-80-79-122-63-136-158-154-135-180-53-100-97-129-57-92-145-179-55-167-128-52-185-106-178-3-14-144-62-9-176-51-184-160-34-54-177-112-44-25-171-175-113-16-120-75-118-59-65-42-43-133-2-78-31-81-90-40-165-23-183-89-114-49-102-137-41-146-159-193-181-22-18-69-108-140-68-115-116-139-46-117-143-0-94-124-101-26-121-151-162-131-149-123-70-86-1-152-148-15"
41,91142,100,41492,132634,33,"79-63-97-129-92-44-75-101-177-54-48-42-115-198-68-139-43-35-84-112-123-162-118-46-0-143-183-144-62-9-137-176-94-26-100-86-53-135-127-70-180-154-184-160-146-22-18-159-34-181-59-167-3-106-196-31-113-175-81-90-165-185-14-49-102-178-179-145-57-55-52-40-119-15-186-89-23-148-152-2-82-78-171-16-25-120-1-80-116-193-41-5-131-149-47-65-72-51-133-151"
42,91138,100,41019,132157,20,"23-137-176-80-123-35-84-112-127-100-26-1-97-121-136-135-70-154-180-63-133-162-47-43-181-34-42-41-193-139-115-184-177-10-54-160-186-15-9-62-144-102-49-14-185-196-25-120-44-75-152-165-90-81-78-145-179-40-178-57-92-129-31-157-113-175-56-16-171-94-149-131-51-68-18-22-116-65-158-53-148-106-55-52-2-101-86-122-79-151-59-118-46-117-143-0-183-89-170-153"
43,90545,100,41230,131775,18,"93-117-143-0-68-160-54-34-22-146-193-41-139-198-46-59-65-116-190-10-177-184-35-152-129-57-92-78-31-113-175-171-16-44-2-100-53-154-94-124-189-121-180-162-149-112-127-151-49-144-80-63-133-194-70-135-79-122-86-75-101-97-26-1-167-52-55-106-62-15-137-23-183-89-186-9-148-51-118-115-176-102-14-40-81-90-165-138-178-3-185-145-120-123-43-42-181-159-18-108"
44,95047,100,46513,141560,22,"100-26-86-75-101-97-1-2-129-92-82-120-152-51-42-34-160-112-127-123-162-151-139-68-118-59-47-181-22-18-108-159-41-193-137-148-25-56-175-157-179-55-52-178-167-154-135-65-116-43-5-115-186-23-89-183-46-117-143-0-63-57-196-90-27-165-106-9-144-14-31-113-81-185-40-119-124-94-180-53-149-131-184-54-177-4-70-44-16-171-78-145-49-102-15-62-80-176-133-79"
45,94166,100,44669,138835,29,"196-92-79-184-54-34-103-146-159-198-139-115-118-80-2-57-179-145-120-82-129-44-25-78-56-157-31-113-175-171-16-178-3-14-144-40-185-106-49-124-121-158-154-180-148-9-62-186-23-183-89-46-65-149-63-100-26-97-1-101-133-42-41-193-160-112-135-53-152-55-52-167-59-181-22-18-108-117-51-176-151-162-70-127-123-116-43-68-140-93-143-0-137-94-86-75-119-165-90-81"
46,95081,100,45319,140400,13,"143-117-93-140-43-131-149-59-118-65-116-177-54-48-34-160-184-51-124-171-31-145-157-78-154-180-158-136-182-63-80-79-70-127-123-148-196-56-113-175-16-25-120-82-152-53-135-133-176-62-9-49-3-178-57-52-106-55-2-101-86-100-121-94-186-183-137-23-89-115-68-18-108-69-22-151-162-144-14-165-90-81-44-75-1-26-97-129-179-40-185-92-42-181-193-159-41-139-46-0"
47,88947,100,40076,129023,21,"178-106-52-55-57-2-1-101-180-154-135-70-127-162-151-118-115-0-89-23-186-9-144-62-49-185-40-165-183-143-117-68-54-160-159-108-18-22-146-34-184-84-112-149-131-77-105-47-43-51-133-63-44-16-175-171-56-113-31-78-75-86-123-65-116-79-129-92-120-25-145-179-196-81-90-27-164-21-14-15-46-139-193-41-181-5-42-59-176-137-80-148-124-94-26-97-53-121-100-152"
48,92163,100,43710,135873,14,"27-39-165-106-178-14-144-62-9-186-89-183-15-102-49-52-55-145-78-92-167-148-137-51-43-5-159-193-22-181-42-162-70-135-127-184-160-54-34-18-69-108-46-100-120-113-171-31-196-40-185-179-57-129-152-80-176-151-123-131-149-47-59-122-124-25-44-16-175-2-75-86-63-115-139-41-48-177-4-112-154-53-101-1-26-180-79-133-65-116-118-68-117-0-143-23-94-97-81-90"
49,87209,100,38682,125891,14,"165-119-40-196-179-145-78-25-120-124-41-193-181-34-146-22-18-108-93-117-143-0-106-185-14-89-183-137-9-102-49-178-52-55-57-75-101-86-180-63-26-100-152-1-97-2-129-92-31-113-175-171-16-44-158-154-127-118-115-139-46-51-151-80-176-65-54-177-4-112-135-70-84-190-10-160-42-59-47-43-184-35-131-116-149-123-162-133-79-53-94-148-15-62-144-21-7-58-164-90"
50,98389,100,48316,146705,35,"75-86-94-124-117-170-143-183-55-57-92-129-79-162-131-47-59-133-100-97-167-148-9-62-186-23-42-181-193-0-102-49-14-144-89-93-68-41-135-70-154-180-26-121-63-122-80-118-51-115-5-43-105-116-65-149-123-151-176-15-114-137-160-54-184-112-127-53-52-106-178-46-18-108-22-103-34-146-159-139-152-44-78-40-185-165-27-90-81-113-171-175-31-16-25-145-120-2-1-101"
51,90156,100,40575,130731,14,"160-42-5-46-0-143-183-165-40-196-81-171-175-16-75-101-1-15-9-102-49-37-148-124-82-92-78-113-56-31-145-179-185-90-21-144-80-43-184-35-131-65-193-108-18-22-146-34-181-159-41-116-123-70-180-100-2-129-57-55-178-14-138-106-52-25-44-120-158-154-135-53-152-167-62-94-162-51-118-115-139-68-117-137-176-79-63-121-26-97-86-136-133-151-59-149-112-177-54-48"
52,96838,100,47098,143936,17,"14-165-90-40-196-145-180-154-135-42-96-193-159-22-34-54-160-181-5-151-80-176-137-108-18-41-118-124-167-102-144-21-7-164-15-186-59-43-184-35-162-75-44-25-78-92-129-62-9-148-51-47-65-79-121-1-2-57-179-52-23-0-117-143-183-175-113-31-171-16-120-101-53-70-4-112-123-194-127-149-131-116-115-46-139-133-63-94-152-86-26-100-97-55-185-119-106-178-3-49"
53,94210,100,45471,139681,20,"59-97-2-145-78-25-44-82-129-92-179-52-178-106-55-57-94-79-133-154-180-152-167-148-62-9-124-121-100-26-53-16-171-185-14-51-109-118-137-23-114-186-183-89-143-93-46-193-43-184-54-177-135-70-86-75-101-63-151-123-159-18-117-0-176-80-144-102-49-165-90-81-40-196-31-175-113-120-1-116-42-5-139-181-22-146-103-34-160-162-127-112-131-149-65-41-69-108-68-115"
54,101110,100,50084,151194,25,"92-179-145-31-113-175-171-16-86-121-42-181-48-54-160-75-120-44-25-78-129-41-193-139-183-89-49-9-176-65-47-116-43-0-143-117-68-131-149-100-101-26-97-152-189-94-79-80-51-59-198-115-118-151-53-158-70-135-133-63-122-124-62-106-185-52-2-1-136-123-35-184-34-146-159-22-46-178-119-40-165-14-144-102-167-127-112-4-177-84-162-180-154-69-18-108-137-148-55-57"
55,97381,100,47321,144702,21,"127-112-4-84-123-162-151-80-137-23-153-0-22-34-160-184-180-86-1-101-97-167-165-40-90-81-113-175-171-196-62-9-189-53-121-63-46-18-108-139-70-154-133-183-89-186-176-51-109-118-59-159-193-41-115-114-15-102-49-31-16-78-145-179-129-92-185-119-52-55-25-75-100-26-152-178-144-14-106-57-65-149-131-42-43-116-68-93-140-117-143-79-122-124-148-94-44-120-2-135"
56,95007,100,46359,141366,33,"34-54-177-112-185-40-165-90-81-57-55-94-127-184-160-181-18-108-151-80-129-78-113-31-145-92-44-120-75-101-86-26-100-124-114-186-46-68-117-143-0-140-198-115-118-51-59-131-47-149-133-79-152-1-97-2-25-16-175-171-53-154-70-135-180-63-49-102-9-15-137-89-183-139-41-193-65-116-162-123-35-84-43-42-5-159-69-93-23-62-178-52-106-138-14-144-148-176-22-146"
57,89760,100,41040,130800,17,"143-183-89-23-137-176-51-109-118-41-193-159-22-181-42-135-154-180-53-121-94-26-97-1-152-49-62-9-148-80-149-131-115-68-93-117-0-46-65-116-160-48-177-54-34-10-190-4-112-127-79-101-129-145-78-55-52-2-75-86-70-84-184-43-35-123-162-133-151-72-59-63-100-179-196-31-175-113-25-120-57-14-144-21-90-40-119-165-178-106-185-92-171-16-44-124-139-69-18-108"
58,98365,100,48099,146464,14,"180-65-5-42-47-133-79-57-40-165-185-52-92-2-1-97-94-0-170-143-117-46-118-116-43-184-160-34-54-177-112-63-167-178-106-55-37-137-41-159-193-139-115-129-145-78-113-175-171-16-101-121-152-102-144-49-14-62-124-80-151-162-123-127-194-122-148-9-90-164-21-15-23-186-176-51-59-131-149-135-70-154-158-53-86-26-89-183-93-108-69-18-22-120-44-31-56-25-75-100"
59,94539,100,44772,139311,17,"113-81-90-119-185-2-101-86-158-180-154-135-70-127-176-137-186-89-51-80-122-63-79-148-62-9-116-43-160-42-118-59-162-26-100-97-144-102-14-165-40-196-31-120-177-54-65-47-151-133-53-75-44-25-145-179-92-129-1-189-94-46-139-18-22-34-181-193-159-41-198-68-115-123-112-184-149-131-124-167-152-57-55-178-3-49-15-23-183-117-93-143-170-0-106-52-78-16-171-175"
60,96050,100,46078,142128,17,"15-62-144-102-49-3-106-90-81-145-189-122-79-63-148-9-14-138-119-40-165-185-112-84-184-159-139-59-124-167-57-129-196-25-120-75-53-101-171-157-31-56-16-44-152-121-127-123-26-97-2-55-52-178-179-175-113-78-92-82-1-94-137-89-183-143-0-115-42-47-116-177-54-181-193-108-18-68-46-51-176-154-100-86-70-135-180-133-162-43-5-41-22-34-160-149-65-118-151-80"
61,96618,100,46152,142770,28,"175-113-31-145-52-106-40-119-90-81-185-129-44-120-2-152-23-0-143-117-46-51-176-178-102-62-116-5-41-193-42-181-34-160-184-131-59-118-109-80-124-148-9-15-137-149-35-112-123-162-151-133-79-94-122-63-194-127-70-154-53-86-16-171-78-92-57-55-139-22-159-43-135-180-100-97-26-1-167-49-144-138-39-165-14-186-115-54-10-177-84-65-198-68-93-183-89-101-75-25"
62,94864,100,43915,138779,14,"9-62-144-14-138-106-178-3-49-43-160-181-159-193-198-46-80-79-135-70-127-123-194-154-180-100-26-133-162-112-4-35-149-131-65-116-42-41-139-68-109-51-176-118-115-59-151-63-75-120-44-55-52-152-97-86-53-84-184-54-177-34-22-18-78-31-185-119-40-171-16-175-113-81-196-179-101-1-148-186-183-89-114-15-102-165-145-92-57-129-2-124-137-12-122-94-23-143-117-0"
63,87155,100,35795,122950,14,"186-23-0-93-117-143-183-89-9-62-165-40-185-57-78-171-175-113-56-85-157-31-196-81-90-179-145-92-129-55-52-14-144-148-124-152-86-101-120-44-2-167-49-178-106-3-82-25-16-75-121-63-79-198-139-41-193-115-59-118-42-54-160-34-146-22-18-108-68-46-109-51-137-176-94-97-1-70-135-133-162-151-123-184-181-5-43-131-149-47-116-65-154-180-158-53-26-100-80-15"
64,90577,100,40339,130916,11,"101-44-16-171-175-113-31-196-40-165-185-106-148-30-54-177-84-80-122-124-94-186-23-183-89-9-62-144-14-178-52-55-49-102-167-152-1-158-154-70-127-135-180-176-51-59-34-48-160-43-79-63-121-100-133-151-162-149-184-181-42-193-139-18-69-108-140-117-93-41-159-22-146-68-46-115-96-5-116-65-123-53-86-75-120-25-78-145-92-129-2-97-137-143-0-118-131-35-112-26"
65,94895,100,44530,139425,19,"25-44-120-162-116-43-160-34-181-42-115-80-124-92-57-185-165-106-52-55-152-97-26-70-127-149-46-117-0-153-186-89-23-137-15-9-102-37-148-139-193-41-22-18-108-93-143-183-176-51-79-63-100-101-75-1-144-14-49-3-167-121-53-135-131-65-94-40-119-81-56-16-171-175-113-129-2-86-180-158-154-122-133-151-123-4-112-84-184-59-118-62-178-78-145-179-27-90-196-31"
66,95044,100,47025,142069,16,"135-75-25-78-90-165-40-185-57-152-184-10-177-54-48-131-149-162-176-124-55-52-106-178-49-148-160-34-181-22-146-42-151-51-118-59-43-18-108-68-46-0-94-97-101-1-86-100-26-121-158-53-154-180-133-79-63-189-2-120-44-92-167-89-183-9-62-137-143-117-93-139-115-129-179-145-196-81-31-56-113-175-171-16-70-112-65-116-193-41-159-23-186-15-144-102-14-80-123-127"
67,90811,100,41999,132810,23,"183-89-186-15-144-62-148-82-25-78-145-92-179-165-119-40-81-196-90-27-164-14-115-159-18-139-46-63-97-152-80-176-51-118-10-177-54-34-181-42-131-149-65-116-59-135-154-180-53-101-86-1-52-185-178-102-9-37-94-79-133-123-162-151-124-167-55-106-49-3-57-129-75-127-43-5-41-193-22-146-160-184-35-4-84-112-70-100-26-171-16-175-113-31-44-120-2-137-143-0"
68,89582,100,40526,130108,17,"78-145-196-31-113-175-171-16-44-25-92-57-55-52-185-165-106-178-3-9-62-144-102-49-129-120-2-75-86-53-158-133-176-151-1-101-70-127-112-4-177-54-34-160-184-96-68-139-93-143-183-148-167-124-94-63-79-162-59-131-149-43-35-123-180-121-152-40-90-164-7-21-14-137-46-117-0-140-108-18-41-146-22-181-116-118-80-97-26-100-154-135-65-42-5-115-198-159-193-51"
69,102248,100,51833,154081,14,"101-179-40-165-39-164-27-90-81-124-160-184-148-37-15-137-51-46-118-133-86-75-120-92-52-106-178-55-57-2-151-162-35-84-112-115-116-5-41-193-79-121-26-53-80-63-70-135-127-123-158-100-97-94-186-143-117-108-18-139-44-16-113-31-196-185-62-144-89-183-0-153-23-9-167-1-152-129-145-78-171-175-49-102-14-176-131-149-43-47-59-65-105-42-181-34-22-159-180-154"
70,85373,100,36217,121590,16,"179-185-106-178-52-55-57-92-129-167-148-89-183-153-0-118-151-162-133-79-51-18-108-41-139-198-46-117-143-93-140-68-115-80-124-94-122-63-65-43-160-34-22-159-193-181-42-116-59-1-152-121-180-53-26-97-100-101-86-154-135-123-112-177-54-48-184-35-131-149-176-137-23-186-21-164-165-27-90-81-175-31-56-113-171-16-78-145-40-138-14-144-49-62-9-2-75-120-44-25"
71,95893,100,45472,141365,20,"41-198-46-68-139-115-121-75-44-120-1-26-100-180-184-160-54-177-34-42-43-51-167-102-49-14-144-15-62-9-37-152-97-2-129-92-186-114-183-89-165-185-40-81-57-56-31-94-124-148-3-178-106-52-55-70-135-127-123-116-65-162-86-113-157-175-171-16-80-151-72-118-59-109-23-137-176-63-79-133-154-53-101-25-78-179-145-196-119-90-27-164-7-21-143-0-18-22-159-193"
72,90657,100,41576,132233,11,"2-1-101-86-26-100-136-63-133-123-149-146-22-18-108-93-117-183-144-49-3-106-178-119-40-81-90-27-165-14-102-118-59-51-176-9-148-180-53-154-135-112-4-10-177-54-42-41-184-35-43-116-65-139-46-0-89-137-80-124-94-79-97-145-78-44-120-75-189-121-152-129-55-185-171-113-31-157-179-57-151-162-131-160-34-181-159-193-115-68-143-23-186-62-52-196-175-16-25-92"
73,90232,100,40562,130794,17,"186-15-185-119-40-81-90-165-106-178-52-152-121-63-176-0-93-117-143-183-89-23-137-151-162-127-123-42-5-131-135-154-86-100-26-97-1-145-82-92-2-101-70-112-177-160-34-43-79-75-120-25-44-57-129-55-179-78-113-171-16-175-31-196-14-144-102-49-9-62-37-148-124-94-80-51-68-193-159-22-184-84-35-47-59-198-139-115-116-65-149-180-53-133-118-41-108-18-69-46"
74,94939,100,44202,139141,15,"196-81-40-185-179-92-2-26-53-63-79-151-133-154-180-162-65-116-47-77-43-42-131-149-184-177-4-112-135-129-57-52-55-102-9-22-34-160-54-181-5-115-139-18-193-41-159-59-78-145-31-16-44-97-100-124-167-148-37-152-1-86-70-127-123-72-118-49-178-106-165-39-27-90-62-183-143-117-0-46-51-144-14-15-186-89-23-114-122-80-66-176-137-94-101-75-120-171-175-113"
75,92260,100,42249,134509,23,"120-75-86-135-127-112-84-4-177-10-190-30-54-34-146-22-18-159-193-41-2-44-16-171-175-113-25-82-129-152-94-151-72-131-149-123-65-46-93-117-115-198-139-68-0-143-183-89-176-51-118-109-162-70-121-1-101-26-100-63-79-122-80-133-102-14-90-165-57-97-53-154-180-9-62-116-43-42-160-184-35-47-59-49-106-185-40-196-31-78-52-55-148-186-23-137-144-178-92-145"
76,93791,100,43055,136846,22,"148-55-57-2-152-97-1-101-26-70-127-123-46-0-170-143-117-108-18-159-41-193-42-5-65-184-84-35-160-34-22-146-195-181-151-133-79-176-93-68-139-63-145-81-90-165-92-129-82-120-121-136-72-59-118-51-109-122-80-137-23-183-89-62-144-14-49-178-40-185-106-52-16-175-171-31-56-113-78-94-115-149-116-47-180-75-25-44-86-162-112-177-54-43-131-135-154-53-100-124"
77,95234,100,45424,140658,13,"102-49-55-57-92-97-127-112-177-54-48-160-184-4-84-35-42-18-108-117-183-9-178-106-119-40-52-118-139-46-89-186-148-37-167-152-1-101-100-26-2-171-175-113-16-44-34-146-22-116-43-181-5-96-115-109-80-145-31-81-90-165-185-3-138-14-144-62-133-151-162-65-149-123-70-53-75-120-25-78-86-154-135-180-63-94-122-79-51-59-159-41-193-68-143-0-176-137-23-15"
78,90969,100,41268,132237,29,"82-44-25-31-113-175-171-16-120-158-70-112-184-160-34-22-146-181-42-43-77-47-65-131-149-127-135-53-78-145-196-55-124-80-46-41-193-159-139-151-133-123-4-190-10-177-54-0-183-89-23-137-94-1-101-63-176-118-59-116-162-154-97-185-119-40-179-92-129-2-152-86-75-14-165-90-164-21-144-49-102-62-9-148-143-117-93-68-115-51-79-122-121-26-100-180-52-178-106-57"
79,90852,100,42798,133650,14,"181-42-41-193-159-146-22-18-69-108-140-68-139-115-0-117-143-89-9-62-144-15-186-137-51-121-26-55-52-2-1-101-100-53-127-123-112-4-10-54-177-190-184-131-149-162-133-94-124-59-116-65-151-97-152-106-178-185-57-92-78-145-179-196-40-90-21-183-23-148-14-165-113-175-49-102-129-82-120-86-63-80-176-25-44-31-171-16-75-180-70-135-154-158-79-118-46-43-160-34"
80,92168,100,43245,135413,14,"122-80-176-51-151-162-149-123-70-75-120-44-25-78-145-179-81-196-90-178-185-165-119-40-57-129-2-26-152-94-133-84-4-112-127-135-154-86-16-171-113-56-175-31-92-167-143-0-93-117-183-15-124-97-101-1-53-184-54-177-180-55-52-106-49-102-144-9-14-62-186-89-46-41-193-159-42-43-181-18-139-115-137-148-114-23-118-160-34-103-146-22-5-131-65-47-116-59-79-63"
81,90543,100,40202,130745,20,"31-90-27-165-178-3-138-14-144-15-89-183-153-0-35-112-135-75-16-113-175-171-44-120-129-2-1-100-133-162-131-65-51-176-80-94-124-23-186-114-37-62-9-148-180-70-127-123-149-184-160-54-34-181-69-108-18-22-146-159-117-143-102-49-167-151-42-5-43-118-59-116-115-193-41-139-46-68-137-79-154-158-53-121-63-26-86-57-52-55-106-185-40-179-152-97-101-92-145-78"
82,96628,100,47759,144387,13,"0-143-63-121-26-86-75-44-16-171-175-113-70-127-4-10-177-184-123-194-154-2-129-52-178-135-112-54-34-181-68-89-183-23-137-176-51-59-43-131-149-180-189-124-9-144-102-49-152-97-101-100-94-80-42-193-41-116-65-118-162-151-133-79-122-148-62-14-138-165-90-81-196-120-1-53-160-22-159-108-18-117-167-78-25-31-145-92-57-179-55-106-185-40-15-186-46-139-198-115"
83,86089,100,36857,122946,19,"123-112-84-184-43-115-46-139-41-193-181-42-116-65-149-160-54-34-195-159-146-22-18-108-69-140-93-117-143-0-183-137-51-151-118-59-162-135-154-180-79-176-102-49-14-3-92-179-196-81-27-90-164-39-145-1-121-133-80-63-53-75-25-78-40-119-165-185-113-171-175-16-44-97-152-100-26-124-94-62-178-106-52-57-55-138-144-15-9-148-2-129-31-56-82-120-86-101-70-127"
84,90971,100,41890,132861,34,"34-54-177-112-127-70-53-1-55-52-57-92-44-78-31-81-90-165-148-176-118-59-65-116-94-2-129-145-179-196-106-178-3-62-15-143-0-46-115-5-42-181-41-193-184-84-35-123-135-120-113-175-171-16-25-75-158-154-180-63-79-133-9-144-21-14-49-137-51-151-80-102-138-119-40-185-152-26-121-97-101-86-100-162-149-131-47-43-160-195-159-139-23-186-89-183-117-18-22-146"
85,86925,100,36892,123817,15,"0-143-117-68-118-59-51-176-186-114-15-102-14-106-55-49-9-62-144-148-100-26-1-97-167-3-178-52-101-86-121-53-180-154-70-135-79-133-162-123-43-116-47-65-149-131-35-184-160-5-42-41-193-181-34-54-177-48-146-22-18-139-198-46-115-151-80-63-94-92-78-82-44-171-25-120-75-137-183-89-124-152-2-129-179-185-40-81-90-27-165-113-31-56-175-16-145-196-57-23"
86,93789,100,44197,137986,25,"181-34-160-54-184-127-1-129-92-196-81-31-113-175-171-16-120-2-101-70-112-4-84-35-162-133-26-97-152-100-53-180-63-79-176-151-72-51-0-117-143-183-89-145-78-25-44-75-86-154-116-193-41-139-46-198-68-140-108-69-18-14-40-165-90-144-15-9-62-186-23-22-159-148-55-57-52-185-119-106-3-178-49-102-114-137-80-118-59-65-47-5-42-43-149-123-135-121-94-115"
87,99516,100,49596,149112,13,"165-40-185-52-14-144-89-183-143-181-34-22-18-108-139-149-131-123-59-151-122-80-63-180-194-135-70-2-1-53-136-121-189-152-26-100-75-101-25-44-129-167-137-0-115-116-65-120-16-171-78-196-31-175-56-113-145-179-97-68-140-93-117-46-112-127-162-133-94-124-79-154-158-86-92-57-55-160-54-184-193-159-41-5-118-148-106-178-49-9-176-43-42-51-62-21-7-164-90-27"
88,95744,100,46687,142431,24,"100-86-75-44-16-171-175-113-31-145-179-185-55-52-106-49-148-139-193-146-22-34-160-43-47-65-42-116-59-118-72-151-133-162-135-70-63-79-80-122-124-97-152-167-178-14-62-9-2-120-129-57-186-183-143-117-68-18-108-159-41-115-40-165-27-90-144-23-89-137-177-190-10-54-184-112-180-136-121-53-154-123-127-94-25-78-81-196-92-0-93-46-176-26-1-101-51-149-131-158"
89,90192,100,37843,128035,22,"108-69-159-193-41-137-23-186-15-9-62-144-102-49-124-94-79-133-118-115-139-46-68-183-89-14-165-52-55-57-145-78-120-82-1-97-101-86-180-80-143-117-0-109-51-66-176-116-42-160-48-177-4-112-127-70-100-26-129-92-16-171-175-113-40-185-152-189-121-63-154-135-151-72-59-65-43-47-131-149-184-35-123-53-75-44-25-2-167-106-178-3-148-122-162-54-34-146-22-18"
90,91617,100,42749,134366,13,"79-80-176-137-23-89-186-148-124-94-189-100-26-97-101-152-52-185-138-144-0-22-159-139-46-143-183-117-123-112-84-184-59-151-154-135-133-162-149-127-70-1-92-145-81-90-27-14-49-40-179-16-171-175-113-2-121-63-115-68-93-140-181-34-160-42-43-116-65-108-18-193-41-5-118-51-9-62-102-21-164-39-165-178-3-106-196-31-56-78-57-55-129-120-25-44-75-86-53-180"
91,97519,100,48641,146160,13,"176-151-149-35-177-10-4-112-180-152-129-145-196-81-90-40-178-9-89-183-143-46-80-79-25-31-175-113-171-16-101-54-34-181-22-146-159-193-160-184-135-53-100-124-148-23-198-139-115-41-140-68-42-43-131-123-154-158-86-75-2-57-102-62-133-162-116-65-59-118-51-49-3-185-165-44-120-1-94-63-26-97-189-167-52-55-78-92-179-106-14-144-93-108-18-117-0-186-114-137"
92,95789,100,44601,140390,19,"75-70-184-160-34-41-193-159-22-18-139-115-68-46-176-80-189-158-53-136-63-122-94-124-148-0-143-170-117-35-112-127-135-154-180-162-123-131-43-42-116-47-65-149-59-118-137-52-55-129-1-101-26-100-121-182-79-51-72-151-133-82-78-92-2-97-152-167-62-144-102-3-178-106-49-165-90-81-196-57-177-54-86-16-171-175-40-185-31-113-145-14-89-183-23-186-9-120-44-25"
93,93967,100,44426,138393,19,"75-44-25-16-171-175-113-56-31-196-81-90-14-183-117-108-69-18-22-146-159-193-139-115-0-186-144-165-40-57-129-2-101-86-100-26-121-189-94-118-59-79-63-133-162-51-176-80-122-97-1-152-167-23-137-143-46-41-34-54-184-120-78-92-145-185-52-178-106-3-49-55-154-123-149-65-35-84-4-112-135-180-53-158-70-177-160-43-151-124-37-148-15-9-62-89-42-5-116-127"
94,89191,100,38812,128003,19,"138-39-165-178-167-94-26-86-158-154-135-127-5-42-181-146-22-41-139-193-159-34-160-65-59-118-68-117-183-89-2-129-120-44-78-145-40-119-185-179-55-106-52-92-57-152-1-101-97-100-123-149-184-177-10-4-75-16-171-175-113-31-157-196-81-90-23-137-151-116-43-131-35-84-112-70-180-53-63-122-133-80-79-162-115-143-170-0-46-51-176-186-15-148-9-62-102-14-49-144"
95,92608,100,43798,136406,17,"101-100-53-135-123-127-70-154-180-121-189-167-129-92-82-120-44-25-171-56-113-175-16-75-86-124-137-183-89-23-144-49-55-52-106-14-165-119-57-152-1-97-94-176-51-193-146-159-22-48-54-160-42-181-34-30-177-10-190-4-112-162-196-81-178-115-41-18-117-143-0-186-62-9-179-78-145-2-26-63-80-79-133-72-151-118-46-68-139-116-184-43-65-149-59-148-185-40-90-31"
96,94575,100,44037,138612,18,"131-149-65-115-46-117-143-186-144-14-62-9-23-93-140-108-18-22-146-159-139-183-89-137-176-80-79-94-1-2-57-92-129-124-189-97-145-179-49-102-148-133-162-151-118-59-5-41-193-181-42-43-116-51-158-154-75-44-120-86-63-122-153-0-34-160-184-135-53-121-101-55-52-90-165-40-106-185-178-167-152-26-100-25-16-171-175-78-84-54-177-10-190-4-112-127-70-180-123-35"
97,94528,100,43763,138291,20,"133-79-122-63-121-94-124-148-9-62-102-144-14-106-185-55-52-178-3-49-137-176-51-59-96-193-139-198-80-97-78-175-171-16-44-120-75-101-152-53-180-135-127-112-4-84-43-42-54-177-10-123-1-2-92-57-15-186-89-183-0-159-34-160-131-149-65-41-69-108-18-22-146-48-35-162-40-165-90-145-179-129-116-5-181-184-70-154-86-100-26-117-143-68-93-140-46-115-118-151"
98,99155,100,50157,149312,18,"31-25-120-86-26-122-80-149-131-35-84-112-4-10-177-54-184-162-1-78-145-40-15-186-89-108-18-22-34-181-159-41-193-9-62-14-179-92-82-63-133-65-43-160-42-118-165-90-106-178-49-102-144-129-2-75-101-53-158-180-151-51-0-117-116-47-59-189-97-44-16-171-175-113-46-115-139-143-183-137-176-94-124-57-185-52-55-148-167-152-100-121-79-123-127-70-135-154-196-81"
99,85045,100,36820,121865,35,"4-112-123-127-70-80-176-137-143-93-108-18-22-146-159-193-115-118-51-72-151-79-180-154-135-65-116-47-131-149-43-41-139-68-117-183-89-9-62-102-57-129-82-2-94-63-133-59-162-53-120-171-175-113-31-92-78-145-179-81-90-144-186-23-15-148-152-1-75-101-97-26-100-86-25-44-16-196-40-185-165-14-49-178-106-52-55-0-46-42-34-160-184-35-84-190-10-177-30-54"
100,99402,100,49576,148978,14,"123-112-4-84-184-10-177-54-48-34-160-43-15-178-57-129-1-97-53-158-135-162-151-133-154-180-167-55-52-148-65-116-42-5-118-176-79-92-196-81-113-175-16-171-31-78-145-152-139-41-115-137-23-0-117-93-140-198-46-68-193-122-63-44-120-2-101-26-100-94-143-183-89-186-114-37-124-51-131-149-14-49-9-102-144-62-165-40-185-106-181-22-18-159-59-80-75-86-70-127"
101,91108,100,41058,132166,13,"152-57-55-52-185-40-119-165-14-9-51-116-5-41-193-139-46-78-175-171-16-44-120-75-26-94-115-22-18-108-117-143-23-62-178-106-196-157-56-113-31-145-179-39-164-27-90-81-92-129-2-97-1-101-86-100-53-154-135-137-89-183-0-118-59-151-65-42-159-146-34-160-181-43-131-123-167-49-102-144-148-124-162-149-35-184-112-4-127-70-180-158-136-63-122-133-80-176-79-121"
102,88907,100,39385,128292,25,"154-180-53-86-75-101-46-108-18-22-146-159-80-148-144-14-165-113-175-171-16-31-145-179-178-49-102-57-120-44-25-78-196-40-119-185-92-129-2-1-9-62-15-186-23-137-176-109-41-193-68-117-0-143-93-139-59-72-151-133-79-51-118-115-183-89-63-100-26-97-55-106-52-152-94-162-149-131-65-43-42-181-96-5-116-123-135-70-127-54-48-34-160-184-84-4-190-10-177-112"
103,91881,100,42359,134240,15,"183-89-23-15-92-145-78-31-113-175-171-16-86-158-70-127-112-34-22-159-139-46-116-47-5-181-42-115-41-193-18-69-108-140-68-79-63-94-80-131-184-35-43-59-118-109-0-117-143-186-185-165-40-44-25-2-152-97-101-53-123-24-149-162-151-133-135-154-52-106-178-55-196-81-90-138-14-144-102-49-167-1-75-120-129-57-148-62-9-137-176-121-26-100-180-160-177-54-65-51"
104,93860,100,45257,139117,22,"145-78-25-75-86-154-135-127-123-131-35-184-160-42-5-139-68-159-193-41-63-152-44-16-171-113-175-56-31-137-89-183-143-94-1-101-120-196-81-90-164-21-62-148-79-149-43-34-54-162-100-2-179-185-40-55-57-97-26-121-180-133-116-181-146-22-18-117-0-46-65-84-112-70-53-167-49-102-124-151-51-118-115-59-176-80-23-186-9-144-14-178-3-106-119-165-52-129-82-92"
105,100614,100,50298,150912,20,"193-159-22-18-117-143-49-165-31-113-175-171-16-75-127-123-65-42-115-46-183-23-124-26-86-100-121-182-63-53-180-154-70-135-79-148-137-51-43-41-139-0-89-114-64-15-149-35-84-112-158-92-119-40-57-97-1-185-27-90-81-179-80-116-184-177-54-160-34-151-94-52-196-145-106-178-78-82-44-25-120-101-122-176-133-162-59-118-152-2-129-55-3-102-144-14-62-9-186-68"
106,94786,100,42701,137487,10,"89-186-15-144-14-185-40-113-175-171-16-25-44-101-86-79-51-117-93-140-108-18-159-41-115-102-49-178-52-106-145-78-120-1-152-57-55-124-80-68-139-118-72-59-198-46-22-146-181-77-162-127-112-4-177-42-5-193-96-65-47-151-133-84-35-184-43-48-54-34-160-100-26-154-135-75-129-92-2-97-121-122-176-137-23-9-62-148-94-63-53-180-70-116-131-123-149-0-143-183"
107,95671,100,46789,142460,37,"135-154-180-102-49-14-3-178-106-179-145-31-56-113-175-171-16-196-165-144-15-186-23-89-183-176-80-124-152-75-57-185-40-79-133-59-46-68-108-69-18-41-159-184-160-181-146-22-193-42-5-115-118-148-9-62-44-120-25-78-81-90-51-198-139-65-116-149-131-101-1-97-53-123-54-177-34-0-143-52-55-94-63-47-43-35-112-4-127-162-151-137-167-92-129-2-26-86-100-70"
108,94073,100,45357,139430,12,"68-160-48-54-177-4-112-123-51-183-89-137-176-80-124-94-86-101-2-145-196-81-31-44-79-151-59-42-5-193-159-41-43-65-47-184-84-35-116-115-139-46-23-15-62-114-186-118-181-34-146-22-108-18-93-117-143-52-55-152-162-131-149-127-135-53-175-113-171-16-75-133-63-129-92-78-120-1-26-121-154-180-100-97-185-119-165-40-90-106-9-144-102-49-14-178-57-167-148-0"
109,93542,100,43535,137077,16,"49-14-144-89-183-115-193-159-22-146-34-160-123-133-176-51-118-59-151-113-175-171-16-31-40-185-52-127-112-177-54-48-47-65-149-131-43-41-139-46-68-117-0-170-143-15-178-106-114-186-23-137-152-1-120-44-53-180-63-25-145-92-179-55-57-129-2-75-101-97-26-86-100-121-162-194-70-154-80-79-122-135-4-84-184-181-42-116-78-81-196-165-90-94-124-167-148-9-62-102"
110,92118,100,42318,134436,16,"129-120-78-145-179-185-21-144-62-9-15-148-176-151-133-127-131-149-65-116-159-22-146-181-160-42-43-79-189-97-152-63-94-124-19-101-1-26-100-121-122-118-115-193-41-139-46-68-117-183-89-119-40-165-90-81-31-113-171-16-175-44-75-2-55-57-138-14-51-59-162-123-35-184-112-135-154-86-53-180-177-54-34-18-108-137-102-49-3-106-178-52-167-80-0-143-23-186-114-92"
111,101148,100,51104,152252,12,"149-65-59-118-51-79-53-86-101-186-114-23-183-143-93-108-18-46-72-70-135-148-62-9-15-137-94-75-44-16-171-175-113-31-89-0-117-68-139-26-97-1-152-2-176-41-193-80-122-124-167-129-179-196-185-90-27-165-63-162-177-4-123-133-14-144-102-57-92-145-40-115-22-34-54-84-112-127-154-180-49-178-52-3-106-55-78-25-120-151-24-35-184-160-42-5-43-116-47-131"
112,89845,100,40653,130498,13,"143-170-117-46-118-135-70-127-123-149-51-176-148-9-49-102-55-145-78-25-44-120-92-57-167-137-193-159-22-18-108-151-133-79-63-158-154-112-184-54-160-34-181-59-80-94-2-129-52-185-40-119-165-144-89-0-68-139-41-115-65-47-116-42-43-131-162-180-16-171-175-113-31-196-81-138-14-62-15-186-23-124-121-53-189-152-1-26-101-75-86-100-97-106-178-39-90-164-21-183"
113,87489,100,38255,125744,14,"135-158-53-97-1-44-16-171-175-113-31-81-90-40-196-179-52-138-14-144-9-148-94-124-2-120-25-145-78-92-129-57-55-102-62-137-23-186-114-15-164-7-21-167-133-162-151-80-89-183-143-117-0-86-75-101-26-100-70-127-4-112-123-149-65-131-184-160-42-5-46-176-79-154-180-136-63-121-152-178-106-185-165-49-51-118-59-115-139-41-193-18-108-69-159-22-146-34-43-116"
114,96327,100,45619,141946,17,"114-89-183-143-0-117-139-193-159-22-146-34-160-42-41-46-15-9-62-178-106-40-185-97-86-180-127-112-4-10-177-162-133-63-94-79-116-65-43-131-80-137-23-186-151-123-149-59-148-179-196-81-175-56-171-31-78-92-3-138-165-90-124-176-122-100-121-136-53-154-135-70-158-101-44-25-57-55-167-51-118-115-184-35-26-1-102-49-144-14-52-2-75-152-120-145-113-16-82-129"
115,92518,100,42976,135494,24,"2-137-183-143-117-108-18-139-41-59-101-44-16-113-175-171-196-179-57-92-120-75-86-70-127-135-180-97-152-94-193-159-22-146-181-43-118-68-0-89-186-23-65-116-131-149-162-148-62-9-49-102-3-138-14-144-15-46-115-5-184-84-112-123-151-51-109-176-124-80-122-154-53-100-121-63-79-54-34-160-42-133-26-1-145-78-31-81-90-27-39-185-178-165-40-119-106-52-55-129"
116,99873,100,50875,150748,19,"9-137-176-51-116-5-41-193-159-22-181-42-43-80-148-57-92-82-75-127-65-131-149-59-151-133-135-70-112-54-34-160-48-177-162-53-86-26-179-81-90-27-21-144-106-178-49-102-3-129-1-180-154-118-68-117-143-0-89-186-14-164-7-185-167-124-123-84-35-184-47-183-23-52-55-165-196-145-2-97-63-79-115-139-46-101-120-44-171-31-25-152-100-94-78-16-113-175-40-62"
117,96070,100,47845,143915,31,"180-124-9-62-15-23-89-183-143-139-159-193-41-137-49-185-165-90-138-14-144-108-18-22-181-177-112-4-84-184-127-70-1-97-176-80-151-149-116-48-54-43-42-5-115-0-186-148-167-152-86-82-57-55-106-52-94-79-63-121-26-53-158-135-123-59-65-68-117-140-93-46-118-51-178-179-92-44-120-145-78-25-2-162-34-160-133-129-196-40-81-31-113-175-171-16-75-101-100-154"
118,102594,100,51614,154208,16,"146-103-34-160-184-127-70-135-86-101-1-75-44-120-2-79-115-139-57-179-185-40-49-167-51-118-59-52-90-165-138-3-178-106-124-122-63-80-176-12-94-148-37-15-23-46-65-35-84-112-180-129-92-14-144-102-114-186-143-183-9-62-26-100-121-53-154-116-41-0-89-55-175-113-31-78-145-152-151-133-162-43-159-193-18-108-93-117-137-16-171-25-97-123-149-42-5-181-22-195"
119,94221,100,44804,139025,26,"152-53-180-158-86-75-44-16-171-175-31-56-113-57-9-124-154-135-43-5-42-181-18-108-159-22-34-139-115-46-167-55-52-185-39-165-106-14-138-144-23-137-0-143-148-102-49-178-3-40-27-90-119-78-145-120-116-41-193-68-117-89-186-62-81-196-179-25-2-1-97-101-26-100-63-123-127-112-84-184-160-54-183-114-15-176-51-59-118-149-65-131-162-151-79-133-80-94-92-129"
120,94341,100,44929,139270,19,"157-31-113-175-171-16-78-145-23-143-183-9-57-92-129-2-101-86-121-80-176-59-118-137-186-15-62-14-178-52-55-37-117-108-18-69-139-115-68-46-51-79-94-124-196-81-39-40-119-165-49-102-152-1-97-180-135-70-162-149-65-131-63-53-158-133-151-184-160-22-159-193-41-0-89-114-144-21-90-179-25-100-26-120-82-44-75-154-123-177-54-34-181-42-43-116-148-167-106-185"
121,93295,100,44169,137464,21,"116-105-43-117-143-23-15-9-148-94-26-100-53-86-101-2-57-196-81-90-165-89-183-0-34-181-160-42-5-115-139-18-108-78-171-31-145-179-167-124-63-154-180-133-79-80-176-72-59-47-149-131-127-123-1-129-92-16-175-113-56-178-14-144-186-137-68-46-51-75-120-25-44-82-97-152-55-52-40-185-106-3-49-102-62-118-41-193-159-22-146-184-54-177-112-70-135-151-162-65"
122,91851,100,41045,132896,16,"180-154-70-135-63-79-80-176-51-109-118-115-139-159-22-34-48-160-42-43-131-86-75-78-179-57-55-52-9-15-59-65-47-149-152-120-175-113-145-92-129-178-3-49-62-148-37-102-106-165-90-14-144-183-46-68-18-69-199-108-193-41-181-5-116-122-121-100-97-26-101-2-1-35-84-184-30-54-177-112-127-123-162-53-44-25-16-171-31-40-185-167-94-124-137-0-117-143-151-133"
123,92371,100,42307,134678,19,"186-23-137-160-54-177-10-190-184-131-151-154-86-75-31-78-92-129-178-102-144-14-165-185-52-55-57-152-94-176-43-42-41-159-22-146-34-84-112-127-123-47-116-72-162-133-63-148-49-106-40-81-196-26-100-25-16-171-113-175-145-179-124-59-118-135-70-194-149-65-115-139-68-93-117-0-143-183-89-2-44-120-97-53-180-193-18-46-51-80-79-122-121-101-1-167-37-9-62-15"
124,97019,100,46939,143958,16,"46-152-92-179-196-31-145-78-151-195-146-22-18-108-117-9-106-40-119-185-52-55-178-102-62-148-124-122-79-53-75-44-171-175-113-16-120-135-35-184-160-34-133-63-154-180-97-100-162-123-112-149-47-116-51-80-2-129-57-165-138-15-186-183-143-0-23-144-14-49-176-65-48-54-177-42-43-5-59-118-115-139-41-193-159-181-131-127-70-26-1-101-86-94-137-89-153-68-140-93"
125,88744,100,37695,126439,17,"4-112-70-135-154-180-59-115-18-22-34-181-42-43-116-65-101-75-31-56-113-90-14-144-9-148-124-94-189-86-158-53-182-136-121-100-26-152-167-52-81-196-169-185-40-119-165-3-55-179-78-145-92-120-25-175-16-171-44-2-137-176-80-63-122-129-57-178-106-49-102-15-62-37-1-97-79-51-46-139-159-193-41-149-123-127-162-133-151-89-183-0-143-117-68-160-184-48-54-177"
126,94496,100,43077,137573,27,"162-151-133-158-53-121-136-180-154-70-135-127-194-123-35-184-54-177-112-86-55-178-3-32-138-49-152-97-1-120-145-196-81-90-165-106-148-137-23-186-118-65-149-131-181-160-42-51-176-52-40-185-179-31-113-16-171-175-25-80-59-41-139-15-102-14-144-114-89-183-143-117-0-9-62-167-26-100-122-79-63-94-124-57-92-2-101-75-44-78-129-46-115-116-193-159-22-34-43-47"
127,92819,100,43162,135981,20,"70-75-44-25-16-171-175-113-31-157-196-81-90-27-39-165-119-40-1-26-100-53-180-63-79-65-160-42-5-43-9-62-144-15-162-116-115-139-68-0-143-183-89-148-124-152-122-159-181-34-184-177-54-22-18-117-23-137-186-176-46-41-193-118-59-51-167-178-49-14-57-145-78-92-80-151-133-136-121-86-101-2-97-189-94-55-106-185-52-129-82-120-154-135-123-149-131-112-4-127"
128,91749,100,41696,133445,20,"185-40-119-165-27-90-81-196-31-78-145-25-101-135-127-123-65-121-100-120-44-171-56-113-175-16-75-70-194-149-131-162-133-80-137-143-0-193-41-115-198-68-139-46-23-186-148-62-49-3-178-106-112-4-177-54-34-160-48-10-190-184-5-42-43-118-176-53-158-154-180-79-51-59-72-151-63-2-129-92-57-52-55-124-94-97-26-86-1-152-14-144-89-183-117-18-22-146-181-116"
129,94258,100,43454,137712,20,"59-42-181-34-160-184-35-131-149-51-62-102-49-3-178-106-120-25-196-81-175-171-78-179-145-92-129-94-65-116-22-18-159-41-43-84-112-123-185-40-165-52-152-101-86-121-182-63-122-162-151-133-79-176-143-0-193-139-115-68-46-117-183-89-23-118-54-177-4-127-135-154-97-75-44-31-56-113-16-124-80-137-186-144-14-57-55-2-1-26-100-136-180-158-53-167-9-15-37-148"
130,91628,100,41885,133513,22,"143-0-117-93-108-18-193-41-139-46-115-118-51-176-59-65-116-184-35-84-112-4-177-54-162-133-63-145-78-53-160-34-146-22-159-151-79-152-129-92-57-101-75-25-120-2-167-62-9-15-148-12-122-94-189-182-121-26-86-1-97-55-40-185-106-178-3-144-14-49-124-180-154-70-127-123-149-42-43-80-165-90-81-196-179-100-135-158-44-16-171-175-113-31-52-102-186-23-137-183"
131,94305,100,44527,138832,12,"112-4-177-54-160-34-146-22-159-193-80-124-82-129-78-171-175-113-81-90-9-137-176-51-118-59-35-184-42-116-65-43-41-68-140-183-89-62-40-185-165-14-144-138-102-52-179-145-31-16-86-158-154-106-3-178-162-123-131-149-122-92-57-55-49-101-26-75-120-44-25-121-63-79-70-127-135-180-1-2-148-37-167-97-152-189-94-100-53-133-151-115-139-18-108-93-117-143-0-46"
132,97784,100,47996,145780,34,"185-80-112-184-54-34-22-159-117-143-0-46-65-59-118-89-148-167-57-92-2-101-86-97-152-189-94-124-158-154-70-135-133-63-129-31-113-175-179-55-52-3-137-176-109-51-122-182-26-121-53-180-162-115-139-41-116-151-79-100-1-120-44-16-171-25-75-127-123-131-42-193-160-43-149-9-102-49-144-15-183-93-108-18-68-145-78-81-90-164-21-186-23-62-14-165-178-106-119-40"
133,89728,100,40601,130329,26,"62-102-14-165-27-90-81-31-113-175-25-44-120-97-100-189-148-124-94-79-133-123-162-151-51-59-118-46-115-139-193-159-34-54-10-177-43-116-41-42-65-149-127-121-26-101-23-186-89-183-117-0-170-143-108-18-22-160-184-48-181-176-137-144-185-40-57-92-75-53-70-112-84-35-63-80-122-180-135-154-158-86-49-178-106-52-145-179-196-3-167-152-1-2-129-78-171-16-55-9"
134,91269,100,40610,131879,12,"31-113-175-171-16-106-178-3-138-14-165-119-40-185-52-167-152-121-180-154-158-53-75-120-44-57-55-92-25-78-81-90-102-62-148-80-79-186-23-137-51-118-46-117-176-97-101-86-26-100-94-124-0-139-193-54-177-42-181-160-34-115-68-143-89-183-114-15-135-127-70-123-131-65-35-184-84-43-5-146-22-159-41-149-151-162-47-116-59-72-133-63-9-49-144-1-2-129-179-145"
135,99445,100,49921,149366,18,"112-70-75-78-145-179-40-119-27-90-165-185-106-178-167-111-94-137-23-186-15-148-124-79-133-51-22-181-160-54-127-44-171-31-56-113-175-157-92-183-117-143-46-118-80-2-129-57-55-52-26-86-1-97-121-176-115-41-193-42-151-122-63-180-53-154-135-116-43-123-162-158-100-101-152-9-144-102-62-108-18-159-139-120-25-16-196-81-14-138-3-49-89-0-59-149-65-184-34-177"
136,94969,100,47039,142008,28,"196-81-90-27-119-40-185-186-0-143-183-89-23-124-152-97-100-26-1-129-31-157-179-106-178-49-137-176-115-139-59-118-72-151-2-82-44-78-145-92-57-55-42-160-54-177-184-84-112-123-127-165-164-7-21-144-14-62-9-148-167-94-63-53-25-113-175-171-16-120-80-34-146-22-181-5-46-117-93-68-51-162-180-154-135-70-86-101-75-133-79-65-116-43-41-193-159-18-108-52"
137,90510,100,40888,131398,16,"176-97-1-152-102-49-3-178-106-119-40-171-16-175-113-56-31-196-185-14-62-9-148-167-124-53-154-79-133-162-65-47-149-131-35-112-123-186-23-89-183-46-139-159-34-160-48-181-146-22-108-18-137-144-165-90-81-120-44-158-180-135-70-2-92-145-78-25-100-86-75-129-55-52-57-101-127-184-177-54-193-41-42-43-105-116-115-117-143-0-118-51-80-94-121-26-63-151-59-72"
138,95684,100,47475,143159,18,"181-22-146-103-34-54-112-127-70-135-154-133-151-118-159-18-69-108-140-68-46-184-177-10-190-51-49-102-89-183-143-114-14-90-81-57-129-92-120-75-1-152-94-80-137-23-9-148-171-16-44-26-59-65-116-123-180-86-101-97-2-52-40-179-145-196-119-165-185-106-3-78-31-175-113-25-124-176-0-117-139-193-41-115-55-178-144-62-15-186-122-63-162-79-53-149-43-42-160-48"
139,93577,100,43695,137272,17,"117-93-68-115-5-47-131-24-123-135-154-100-26-101-75-86-53-180-151-112-4-84-190-184-34-146-159-22-18-97-2-129-92-120-152-1-94-124-80-79-118-65-105-43-48-177-10-54-160-116-59-63-49-3-178-165-57-55-167-133-162-149-35-127-70-158-171-16-175-31-113-185-106-14-62-15-137-148-9-144-21-90-40-196-145-25-44-78-52-46-139-41-193-181-42-51-176-183-143-0"
140,89548,100,39211,128759,12,"144-102-49-14-138-165-185-40-90-81-196-31-78-92-129-97-135-70-127-123-162-149-131-43-193-181-160-48-30-34-42-116-65-115-46-0-137-80-121-86-16-175-171-113-145-179-57-52-106-178-55-82-74-19-189-26-1-2-120-101-100-79-180-154-158-63-53-152-124-167-148-9-62-18-108-159-22-146-41-139-143-183-89-176-151-59-112-4-177-54-184-118-51-133-44-25-75-94-23-186"
141,92227,100,44469,136696,27,"144-21-164-90-165-40-81-196-44-129-152-1-97-151-72-118-59-116-177-10-4-26-2-55-57-92-113-16-175-171-31-25-75-162-65-131-112-84-35-115-139-41-5-43-149-123-133-122-176-143-0-183-117-93-108-18-22-193-124-120-78-145-179-106-178-167-94-53-70-127-135-154-180-86-101-100-63-79-80-148-52-185-14-49-102-15-51-184-54-34-42-160-181-159-46-89-23-137-9-62"
142,93176,100,43760,136936,18,"93-108-18-22-146-34-181-42-116-176-49-3-106-52-55-185-40-179-57-129-124-94-59-193-159-5-47-65-133-63-1-75-2-144-14-178-165-27-90-138-102-80-151-162-123-84-4-112-194-154-44-25-56-113-78-92-148-137-139-41-54-48-160-43-35-127-135-70-180-53-101-86-97-152-23-183-89-9-62-145-31-16-175-171-82-120-79-51-118-115-10-177-184-131-149-46-68-0-143-117"
143,92247,100,42546,134793,16,"72-162-133-180-154-158-86-75-16-171-175-113-40-106-9-62-183-143-117-0-46-139-193-41-5-181-195-159-22-146-84-112-4-131-65-116-47-59-118-79-124-2-101-70-177-54-48-160-42-43-80-148-178-49-144-14-138-81-196-145-92-57-100-26-179-119-90-165-185-55-52-129-152-97-1-121-53-123-149-184-34-35-127-135-44-31-78-25-120-137-68-108-18-115-51-176-94-63-122-151"
144,89823,100,40733,130556,23,"185-138-14-102-144-183-93-108-22-146-181-34-160-116-148-178-179-78-16-171-175-113-31-145-92-57-55-52-3-49-63-79-133-176-137-15-62-9-51-35-177-54-159-18-117-143-0-80-94-124-189-101-1-75-86-180-162-112-84-184-42-41-193-43-47-65-151-122-97-121-158-53-154-135-70-127-123-149-59-118-46-139-115-152-25-44-120-26-100-2-129-106-7-164-90-165-119-40-196-81"
145,91324,100,41542,132866,14,"121-100-26-86-75-120-44-16-171-175-113-31-78-25-180-135-79-72-118-198-68-139-41-181-160-34-146-22-193-115-137-148-144-14-167-2-1-97-152-52-106-39-27-90-81-40-176-80-53-101-129-92-145-196-179-119-165-185-55-57-178-3-49-62-102-9-94-177-54-43-116-65-151-154-70-127-184-42-96-5-47-149-59-51-162-4-112-123-131-0-143-23-89-183-117-18-108-46-133-63"
146,96206,100,45554,141760,17,"22-34-160-184-123-53-121-167-102-144-14-138-119-40-185-152-97-1-2-120-113-175-16-44-75-154-112-4-10-177-162-133-178-106-39-165-27-90-81-196-55-129-57-151-118-65-116-43-127-70-135-63-80-186-23-89-0-137-15-62-9-37-148-12-124-176-149-131-42-59-180-86-101-171-31-179-52-3-49-139-41-193-117-143-183-114-92-145-78-26-100-189-94-122-79-51-115-46-18-159"
147,90648,100,41195,131843,17,"0-143-183-89-186-15-144-14-55-57-25-44-31-81-196-40-185-179-92-51-116-5-41-193-159-18-22-181-123-154-100-101-75-152-94-133-79-122-180-158-53-121-26-1-97-189-63-162-135-127-112-84-184-177-160-34-54-42-43-70-86-16-175-113-171-56-90-27-165-102-9-62-129-82-145-78-120-2-117-93-139-68-118-151-176-80-23-137-148-49-178-106-52-167-124-72-59-65-115-46"
148,93842,100,43619,137461,12,"183-89-23-186-15-124-94-80-123-112-84-184-22-159-193-41-43-63-100-101-97-122-176-51-116-65-149-70-75-120-196-81-90-27-39-106-178-3-138-14-165-40-167-137-139-46-68-117-93-108-18-144-49-102-55-52-185-175-113-31-145-179-9-62-148-189-26-154-158-86-44-78-171-16-1-135-127-160-34-181-42-5-118-59-162-151-133-79-129-92-57-2-152-121-53-180-72-115-0-143"
149,92101,100,42424,134525,11,"162-133-79-151-51-118-59-65-116-43-5-42-181-193-41-139-159-22-18-108-68-23-152-120-145-25-44-75-86-26-100-97-2-186-89-183-0-117-143-137-129-78-31-113-175-171-16-101-1-119-40-185-81-196-179-92-57-167-122-80-176-15-144-49-9-178-106-55-148-62-102-14-138-63-112-177-160-34-184-35-70-194-135-131-149-115-46-154-53-94-124-37-3-165-90-52-121-180-127-123"
150,97453,100,47688,145141,14,"138-14-144-18-159-22-146-34-160-54-177-184-112-75-120-129-44-25-16-78-145-31-196-81-40-185-106-55-52-178-176-80-151-133-79-63-122-124-94-53-180-154-70-65-118-137-62-9-56-113-175-171-149-43-181-41-193-123-135-86-1-51-139-68-117-183-89-186-114-102-49-167-148-15-23-46-93-140-0-170-143-101-26-100-152-74-2-82-179-92-57-97-162-59-115-42-116-119-90-165"
151,91740,100,40150,131890,15,"90-27-164-21-144-14-49-102-62-9-178-52-106-3-138-119-185-145-25-78-196-40-165-137-139-22-193-41-115-59-118-0-170-143-23-186-15-148-176-116-43-65-149-151-133-79-124-55-92-120-75-26-97-1-129-2-152-189-121-70-123-112-4-177-184-160-34-42-135-158-86-31-113-175-171-16-44-94-80-46-68-93-117-183-89-51-63-122-162-154-182-100-53-180-136-101-82-57-179-81"
152,86846,100,36882,123728,30,"149-131-184-160-43-77-47-65-59-118-115-193-69-108-18-22-159-139-137-176-80-122-53-63-100-97-101-75-44-25-113-196-81-90-165-14-57-92-16-171-175-31-106-49-186-0-46-68-140-93-117-170-143-183-89-23-152-2-1-26-154-135-54-34-181-42-41-5-116-123-162-151-133-51-79-121-94-124-52-55-185-119-40-78-145-179-167-148-9-62-144-178-129-82-120-86-180-70-127-112"
153,100459,100,50196,150655,15,"123-35-184-160-34-146-22-18-199-193-41-5-42-43-118-9-62-55-185-40-119-148-59-47-181-159-69-108-68-139-115-116-65-15-49-178-106-124-135-63-37-102-144-14-183-143-51-180-53-86-75-152-92-57-129-1-101-154-112-4-10-177-127-70-25-44-78-133-162-149-131-176-23-186-137-122-121-100-26-165-90-31-171-175-113-56-16-145-52-167-80-151-0-117-46-2-120-97-94-79"
154,102268,100,51773,154041,13,"175-171-16-41-193-69-108-18-22-159-139-14-138-185-25-44-75-123-177-54-34-160-65-2-78-145-196-81-31-94-115-198-68-117-143-0-153-23-15-9-178-106-167-151-116-5-42-127-70-154-158-53-121-100-26-97-1-179-52-49-102-37-148-79-162-149-184-43-46-183-89-186-114-62-144-80-176-51-118-59-137-129-57-92-124-189-180-63-86-101-165-90-40-55-152-133-194-135-120-113"
155,95296,100,47419,142715,22,"120-196-81-90-164-21-186-93-108-18-22-146-42-149-59-79-94-52-55-57-97-162-151-133-121-101-152-15-144-9-62-102-49-14-106-178-124-80-118-184-112-123-135-70-154-180-63-53-26-1-2-44-16-171-31-40-165-119-185-179-78-92-167-68-139-5-116-65-177-10-54-46-0-117-143-89-183-23-176-122-129-145-113-175-25-160-181-193-41-159-34-43-115-109-51-137-148-100-86-75"
156,89156,100,40309,129465,22,"183-89-23-186-62-185-196-31-113-175-171-16-145-40-119-165-27-90-81-179-133-41-193-159-22-195-160-34-54-177-184-112-70-75-78-25-44-82-120-57-55-52-178-129-1-97-2-152-94-63-79-122-123-149-131-43-42-181-146-69-108-18-117-137-124-167-9-148-180-154-127-65-116-115-139-46-51-59-176-151-80-92-106-138-14-21-144-102-49-26-100-101-86-53-135-162-72-118-0-143"
157,100925,100,51769,152694,20,"198-139-115-118-151-180-158-154-135-177-54-34-181-42-160-116-65-59-102-106-14-185-113-171-31-145-179-57-52-152-97-53-70-127-133-94-167-178-55-196-81-92-2-121-75-86-79-80-183-89-143-0-68-41-43-119-40-90-165-114-117-22-159-193-18-108-93-144-49-148-124-162-112-184-149-123-26-25-82-78-129-9-62-15-137-23-186-51-109-176-63-189-44-16-175-120-101-1-100-46"
158,90368,100,40890,131258,19,"41-159-22-146-5-59-44-16-171-175-113-56-31-25-78-145-55-52-185-40-119-49-9-137-23-186-15-62-102-148-176-80-151-135-70-154-53-86-75-120-129-92-152-63-122-79-158-180-123-65-139-68-140-93-46-35-184-54-177-160-34-181-0-117-198-193-108-18-144-14-178-3-106-165-90-81-196-57-2-1-51-118-143-183-89-124-26-121-94-100-97-101-133-162-149-131-42-43-116-115"
159,99298,100,50695,149993,18,"119-40-175-171-16-25-93-108-18-22-159-162-180-63-23-143-183-89-186-122-154-70-127-123-133-79-144-21-7-164-178-151-149-65-118-148-49-14-102-9-62-116-47-43-160-34-181-193-41-94-92-129-124-167-82-44-120-75-97-68-117-0-137-179-145-78-31-113-81-90-165-57-1-101-152-52-106-80-176-51-59-115-198-46-139-5-42-184-177-10-4-112-135-53-100-86-26-2-55-185"
160,90917,100,42338,133255,11,"159-22-18-69-108-93-140-44-25-16-171-81-196-185-14-144-62-186-23-89-183-137-176-124-167-82-120-26-123-162-133-122-79-149-131-65-47-43-181-34-160-54-177-127-70-154-135-112-84-184-42-41-193-46-115-51-9-102-52-55-178-106-57-75-86-53-121-148-49-179-31-113-175-145-78-40-119-165-90-92-129-2-152-94-80-151-118-59-116-139-68-117-0-143-63-101-1-97-100-180"
161,91677,100,41162,132839,20,"185-119-40-145-179-52-14-144-9-62-80-176-115-41-193-159-22-18-108-139-68-117-0-143-46-116-131-35-184-84-112-97-1-26-137-183-89-114-15-186-23-51-59-65-47-149-162-151-133-2-57-55-178-49-102-167-120-16-25-44-101-86-121-63-158-180-53-100-152-82-78-196-31-113-56-175-171-75-154-123-127-135-94-124-37-148-79-118-42-34-160-43-165-39-27-90-81-92-129-106"
162,95316,100,43011,138327,12,"143-183-144-14-138-165-40-90-81-113-31-78-25-97-63-154-180-158-53-189-152-46-22-18-137-178-52-57-179-92-129-2-75-86-101-1-44-16-171-175-145-49-102-37-148-124-94-12-176-118-151-122-80-79-135-127-123-3-106-185-55-120-70-160-181-193-115-41-159-5-42-43-47-65-116-162-72-109-51-59-131-149-35-184-54-34-103-146-0-89-62-9-167-26-100-121-133-139-68-117"
163,89120,100,39704,128824,12,"44-75-86-65-116-59-118-79-63-23-89-140-93-117-0-143-183-137-124-152-1-97-101-26-100-70-135-162-72-151-80-176-146-22-18-69-108-148-185-81-196-157-31-113-171-175-16-145-92-129-120-57-49-102-144-62-9-178-3-138-32-106-14-90-40-165-52-55-94-189-121-53-154-180-133-51-139-41-54-160-34-181-193-159-46-68-115-42-177-4-112-84-184-43-149-123-127-2-25-78"
164,95048,100,45681,140729,18,"63-92-179-145-78-25-44-26-100-176-137-23-89-183-151-162-127-123-149-72-118-160-5-139-93-117-143-16-31-113-171-175-196-81-90-165-40-119-185-138-14-80-112-184-54-177-42-181-159-69-108-46-115-96-116-43-180-53-101-97-1-120-82-129-57-49-102-144-52-55-124-94-135-154-86-75-2-152-41-193-0-186-9-62-178-106-148-51-59-47-65-131-48-34-22-146-18-68-133-79"
165,88929,100,39642,128571,23,"102-62-9-186-23-89-183-114-15-167-82-25-16-175-171-113-56-196-52-55-2-1-101-75-86-53-135-70-127-112-123-97-92-179-145-78-31-157-81-90-185-148-137-65-116-131-149-162-180-154-79-63-144-14-138-178-80-151-43-42-160-34-18-139-198-46-115-193-41-159-22-146-181-48-54-177-184-68-117-143-0-176-94-124-57-129-152-122-51-59-133-100-26-120-44-40-165-106-3-49"
166,93124,100,43463,136587,25,"196-31-113-175-171-16-70-184-43-59-162-148-49-102-62-183-89-55-57-152-97-26-100-94-12-137-143-0-117-46-41-193-34-48-160-54-177-10-190-84-35-151-133-86-101-1-2-129-92-145-78-25-44-120-75-121-182-63-180-53-154-135-127-123-112-131-149-115-139-68-79-80-185-40-165-14-93-18-108-69-116-118-51-65-5-181-22-159-42-176-124-167-52-106-178-144-15-186-23-9"
167,93192,100,43845,137037,13,"143-170-117-93-0-51-151-162-86-101-1-97-26-100-180-154-135-127-184-177-10-190-4-112-70-53-124-167-57-52-185-14-144-49-106-178-55-176-133-79-94-152-44-120-25-129-92-2-75-123-149-43-131-16-171-113-175-90-27-39-165-62-9-15-118-160-34-181-146-22-159-59-80-63-122-186-23-89-183-108-18-41-193-139-46-115-5-42-116-47-65-40-196-179-145-31-56-78-148-137"
168,95618,100,41782,137400,19,"102-40-90-165-138-14-148-137-181-34-160-184-53-86-25-44-120-65-146-22-159-193-41-96-5-149-131-42-43-116-47-123-127-70-135-162-115-46-89-144-9-62-49-106-52-178-3-55-92-129-2-167-124-176-133-151-136-121-189-152-1-57-145-179-185-75-101-154-180-94-186-23-183-196-31-113-175-78-16-171-100-26-97-63-79-122-80-51-59-139-68-93-117-143-170-0-153-76-114-15"
169,92218,100,43090,135308,21,"16-171-175-113-31-78-120-0-140-93-117-143-15-144-14-185-40-81-90-27-165-52-62-9-186-23-137-46-139-22-159-193-199-18-69-108-68-183-89-124-94-79-63-26-97-152-101-75-70-127-123-51-176-109-118-59-54-177-112-180-129-106-178-49-148-122-151-162-65-181-146-34-41-115-5-184-35-131-149-116-42-160-48-43-80-55-57-92-145-44-25-154-133-135-53-86-100-121-1-2"
170,93377,100,43628,137005,11,"148-124-94-189-121-53-63-122-137-23-186-144-102-49-165-185-2-1-101-86-158-135-162-112-123-127-70-16-171-175-113-56-31-151-65-159-22-146-177-10-54-42-41-193-198-89-183-143-170-117-0-93-140-108-18-69-139-59-176-80-167-55-52-106-57-152-79-43-184-160-34-181-5-115-116-149-133-180-154-92-78-120-75-97-26-100-51-118-68-46-14-90-40-145-25-44-129-178-62-9"
171,96017,100,46020,142037,17,"97-180-160-34-54-184-183-89-23-186-15-9-57-78-179-40-185-52-148-117-93-68-139-18-22-181-42-118-62-144-49-196-81-157-31-56-16-175-113-171-145-92-25-120-44-55-3-178-106-167-94-124-109-115-46-193-41-116-137-114-102-14-189-121-26-100-53-154-135-70-133-65-59-149-131-43-35-123-127-112-4-162-151-80-122-79-176-152-63-51-143-0-165-90-129-101-86-75-2-1"
172,95643,100,46225,141868,13,"49-102-37-148-80-133-123-149-65-43-116-176-9-62-14-138-3-178-2-86-154-180-63-137-23-89-0-51-162-70-97-78-31-171-113-16-175-145-179-92-152-94-167-52-55-90-27-164-21-144-15-118-115-42-181-34-160-54-177-135-121-100-101-1-26-75-25-44-57-185-40-165-117-46-139-68-41-193-159-22-18-143-183-186-53-120-129-82-124-12-122-79-151-59-184-112-84-4-127-106"
173,92584,100,43632,136216,17,"135-123-43-42-181-34-54-177-84-35-131-47-65-116-151-44-16-171-89-183-117-93-140-68-46-176-80-148-178-165-39-164-27-90-81-157-31-145-92-52-138-14-144-102-49-167-94-152-97-124-23-186-15-9-62-55-120-75-70-127-112-146-22-159-193-139-115-106-185-40-196-175-113-78-179-57-129-2-63-59-41-160-184-149-162-79-100-86-1-101-26-137-143-0-118-51-133-154-53-180"
174,93317,100,43646,136963,14,"139-22-159-193-41-118-180-53-100-86-101-1-2-52-3-49-102-14-185-157-56-113-175-171-196-145-81-119-179-92-57-55-148-186-23-0-153-183-15-90-40-165-164-7-21-144-62-9-129-25-75-94-80-79-124-120-44-106-178-167-137-89-143-117-46-115-149-123-127-151-133-65-43-116-51-176-152-78-31-16-154-70-135-162-35-84-112-4-177-184-54-34-160-42-59-122-63-121-26-97"
175,89787,100,40875,130662,23,"145-92-57-129-2-94-51-46-198-68-117-143-183-89-23-62-14-165-185-40-81-90-21-186-0-108-18-22-159-139-115-65-116-35-112-84-48-160-34-193-41-43-59-80-122-63-154-135-162-133-79-176-137-15-9-144-102-49-167-124-26-1-101-86-120-44-25-16-171-175-82-97-151-42-181-184-10-177-54-30-118-148-106-178-3-138-55-52-152-100-180-149-131-123-70-53-75-78-31-113"
176,88501,100,39281,127782,18,"151-133-158-53-100-86-70-135-154-180-79-63-26-97-152-189-124-94-162-34-146-159-193-115-109-51-15-9-144-14-49-178-62-148-183-143-117-123-149-131-184-177-190-10-54-160-139-0-89-23-137-176-59-118-46-68-108-18-22-181-116-65-80-121-101-1-2-44-25-196-165-90-81-40-119-185-57-129-120-78-92-52-55-106-179-31-113-175-16-171-145-75-112-84-35-43-42-96-41-5"
177,92881,100,42011,134892,22,"176-148-9-15-23-153-117-68-118-51-80-63-120-2-75-1-26-53-154-70-127-193-199-18-69-108-36-140-93-137-124-152-171-175-81-196-145-78-94-122-79-151-72-59-47-116-5-42-35-184-160-181-146-22-139-41-46-115-149-162-123-112-177-54-34-159-183-89-144-14-49-57-129-92-31-113-16-44-25-52-165-40-185-55-178-106-62-186-143-170-0-133-180-97-101-86-135-131-43-65"
178,94607,100,43301,137908,27,"171-175-113-31-196-81-119-185-138-14-3-52-44-25-78-145-179-106-178-49-0-117-143-183-89-114-9-15-148-1-120-75-86-154-135-70-101-124-167-55-57-92-2-115-193-41-160-34-54-184-177-4-112-127-79-122-176-62-102-21-7-164-165-40-90-39-144-51-118-131-149-123-158-100-53-180-43-116-42-139-46-59-151-26-152-97-133-162-65-47-63-121-94-80-23-186-137-37-129-16"
179,88175,100,38494,126669,25,"4-190-10-177-184-35-79-52-81-196-179-145-92-106-178-3-14-138-31-113-175-171-16-78-44-63-51-118-46-117-143-183-89-186-23-137-109-59-115-139-193-41-160-43-5-42-48-54-34-181-149-131-65-116-159-22-108-18-0-9-57-129-120-25-82-2-154-135-86-26-100-53-180-162-72-151-133-176-80-124-94-152-97-101-75-121-1-167-55-185-40-90-165-49-102-144-62-148-123-112"
180,90392,100,41416,131808,25,"14-144-62-9-15-89-183-143-117-68-41-42-181-160-184-43-148-106-165-90-81-78-25-75-26-100-86-51-109-115-116-149-123-135-154-70-180-158-53-63-80-94-101-2-57-52-178-102-0-118-72-162-133-79-93-108-18-22-34-54-10-177-159-193-139-46-176-151-194-127-4-84-112-35-65-59-137-23-186-167-92-171-16-113-175-31-145-179-55-124-97-152-1-44-120-129-40-185-3-49"
181,93034,100,43588,136622,22,"81-196-106-178-3-14-102-62-9-49-52-185-40-165-90-21-144-186-117-68-5-42-116-47-65-122-63-79-154-180-123-149-43-115-41-22-193-139-46-59-118-183-137-133-70-127-135-136-121-1-57-179-55-131-184-54-177-112-151-148-167-145-78-171-16-120-44-86-160-34-181-159-18-108-93-143-0-89-23-124-152-97-101-94-100-26-80-176-51-72-162-158-53-75-2-129-92-31-113-175"
182,93105,100,43985,137090,14,"16-171-175-113-56-31-179-55-62-148-124-94-176-122-79-133-151-23-186-89-183-143-139-59-118-135-154-53-97-1-120-57-152-63-123-65-42-146-22-181-34-48-43-41-159-193-115-78-145-196-185-40-92-129-70-127-162-51-80-26-86-100-180-158-121-167-3-178-106-52-119-39-165-164-27-90-144-15-46-116-184-112-4-177-54-160-108-18-117-0-137-9-14-138-102-49-101-75-2-44"
183,103817,100,53982,157799,12,"55-185-40-138-144-114-89-183-63-121-189-152-90-165-15-143-117-108-22-34-42-139-46-14-81-196-179-145-92-129-148-0-93-68-193-149-70-158-86-75-1-101-100-131-43-186-23-9-62-49-57-78-31-157-113-56-175-171-16-53-41-159-18-137-102-106-52-3-178-167-115-181-160-80-176-124-94-122-79-151-162-123-127-112-184-116-65-135-154-2-120-44-25-97-26-180-51-59-118-133"
184,88039,100,37982,126021,24,"160-35-123-127-70-135-162-118-59-65-184-54-30-177-10-190-4-112-131-149-180-53-26-100-44-171-56-16-25-78-106-52-55-165-39-27-90-186-23-143-0-89-183-117-108-18-22-159-139-115-41-193-42-116-133-80-176-137-62-102-14-3-57-145-179-167-63-151-51-79-122-136-158-154-121-94-124-152-101-75-129-92-97-86-1-2-120-175-113-31-196-40-185-178-49-144-9-148-43-34"
185,93036,100,43421,136457,19,"63-122-79-180-158-53-100-121-94-148-9-62-55-57-92-129-97-154-70-127-135-123-131-149-151-133-86-75-44-120-43-116-47-65-59-52-106-165-185-145-2-152-167-15-186-23-89-117-46-115-96-5-42-118-51-176-80-137-114-183-143-0-139-193-22-18-108-140-93-68-41-34-48-54-177-10-4-25-31-113-175-171-16-178-3-49-14-144-40-90-81-78-112-84-184-160-162-1-101-26"
186,91469,100,42009,133478,12,"40-165-90-21-144-186-89-183-143-117-137-178-106-14-102-15-23-0-68-159-146-22-181-160-35-123-151-176-148-9-62-49-52-55-2-121-182-63-79-133-162-72-59-43-184-54-177-34-18-115-116-5-42-84-112-127-70-86-100-53-149-131-47-65-135-154-75-44-78-145-179-56-113-31-25-180-118-51-46-139-193-41-80-124-94-1-97-26-101-82-129-57-152-120-171-175-16-92-196-185"
187,90977,100,41752,132729,28,"164-7-21-183-143-0-176-63-182-121-100-26-180-68-108-18-22-181-42-43-116-59-51-15-9-62-49-14-144-102-167-94-133-162-112-177-54-48-34-160-184-151-79-122-80-46-115-131-123-127-70-154-53-135-149-65-41-193-139-118-120-16-171-175-56-157-31-113-78-145-152-124-137-23-186-148-52-3-178-106-185-119-196-129-86-75-2-57-92-55-40-179-25-44-1-101-97-81-165-90"
188,93522,100,44104,137626,16,"21-7-164-90-81-196-178-106-26-53-86-75-2-40-185-49-167-1-101-120-25-78-145-92-57-129-44-16-175-113-171-94-0-108-69-199-18-159-43-184-54-160-22-146-181-34-193-80-152-97-70-135-123-4-112-65-117-143-183-89-176-133-151-162-118-51-186-23-15-9-62-144-102-14-138-39-165-119-52-55-137-115-116-79-122-63-180-154-127-131-149-59-46-68-139-41-42-5-148-37"
189,95884,100,46794,142678,15,"171-175-113-31-78-145-81-90-27-164-21-14-138-106-178-144-15-89-183-116-47-131-176-167-49-185-40-165-179-152-124-23-137-139-115-5-42-160-184-180-97-55-52-92-2-75-120-44-129-57-186-143-117-34-54-10-177-41-193-22-159-43-149-162-151-133-135-70-123-46-0-80-122-94-26-100-79-51-59-65-118-62-102-9-148-93-140-108-18-181-127-194-154-158-63-53-86-1-101-16"
190,93974,100,43234,137208,23,"31-157-196-40-119-185-138-3-106-178-122-133-162-135-70-16-171-175-113-25-44-120-82-129-2-75-86-65-115-41-193-181-146-22-159-5-43-42-184-112-180-26-101-154-158-53-80-59-118-109-0-137-148-102-49-14-165-27-90-81-179-100-97-121-63-94-124-176-46-68-117-23-89-183-143-139-51-57-145-78-92-144-9-62-37-1-152-79-151-116-160-34-54-10-177-123-127-167-55-52"
191,87285,100,35305,122590,49,"22-159-193-41-115-80-120-44-16-171-175-113-2-152-26-100-53-154-70-127-112-4-84-35-131-149-72-151-79-63-121-97-1-101-75-158-180-133-43-42-34-160-184-54-116-65-162-123-135-86-25-145-179-91-119-40-90-81-157-31-56-52-37-148-167-9-62-15-51-59-118-109-176-94-129-78-196-185-165-14-144-102-49-3-178-106-55-57-92-114-186-89-183-23-137-0-143-117-46-139"
192,93560,100,43126,136686,11,"112-184-160-34-181-146-22-18-108-69-96-5-42-43-115-118-59-72-151-133-94-165-40-90-81-196-80-176-148-178-106-14-144-102-49-185-55-52-179-31-145-78-44-120-92-57-15-68-36-140-93-117-186-9-62-167-129-2-97-180-158-53-100-86-75-154-70-123-135-51-0-143-139-193-159-195-41-46-137-89-183-23-122-63-26-101-175-113-56-16-171-25-116-65-162-79-124-152-1-127"
193,95535,100,44971,140506,27,"149-131-65-35-184-48-34-160-43-15-62-52-145-129-101-120-25-78-31-113-175-171-16-44-82-57-3-14-144-102-49-55-2-26-100-97-75-70-127-123-194-158-121-189-53-63-79-151-41-22-18-139-117-0-143-46-51-122-124-167-106-178-148-116-42-181-159-193-115-54-177-112-162-196-81-90-165-9-80-176-59-118-137-89-183-23-94-152-1-92-179-40-185-86-136-182-133-135-154-180"
194,89886,100,40303,130189,20,"15-137-51-131-149-162-79-148-9-62-102-144-14-138-3-178-55-57-92-25-44-120-2-152-97-53-158-154-70-127-123-112-84-35-184-42-43-116-65-63-121-86-75-185-81-196-101-180-135-4-177-160-159-41-193-22-146-181-34-54-48-165-90-27-164-21-89-183-0-143-46-59-118-72-133-151-115-68-139-176-80-94-124-167-52-179-129-1-26-100-78-171-16-175-113-31-145-40-106-49"
195,89960,100,40386,130346,29,"146-22-18-108-159-193-41-139-68-46-176-80-82-44-25-78-92-129-70-135-133-137-183-89-9-62-144-102-49-178-106-55-57-145-31-113-56-175-171-16-120-2-152-124-94-189-26-75-101-1-86-158-180-154-112-177-54-184-35-123-162-79-148-167-40-165-186-23-51-118-59-43-5-42-160-151-122-63-136-53-97-100-121-127-149-131-65-116-0-143-52-196-81-90-185-14-15-115-181-34"
196,93727,100,44789,138516,13,"146-22-18-108-159-193-41-34-54-177-10-190-65-116-118-115-109-51-131-149-151-176-80-79-133-180-26-16-113-175-171-75-101-86-189-94-186-183-139-59-46-68-117-143-0-89-23-137-42-184-127-1-129-145-106-148-167-124-162-135-70-53-121-100-97-120-2-44-25-57-49-144-14-90-157-31-78-152-158-154-82-92-9-62-165-185-40-196-81-179-55-52-178-63-123-112-43-181-160-195"
197,88597,100,38071,126668,16,"176-51-118-41-193-181-160-54-177-184-34-22-18-108-117-0-143-183-59-65-116-139-68-46-115-5-42-43-84-4-112-127-135-154-180-53-80-137-23-186-9-167-56-113-82-152-74-92-57-81-90-27-119-196-145-78-16-175-171-31-25-124-94-63-182-121-100-86-101-97-179-52-39-165-178-62-120-44-75-162-123-149-151-133-79-26-1-2-129-55-185-40-3-106-144-102-14-138-49-148"
198,93084,100,43919,137003,13,"158-154-135-162-72-51-148-9-62-14-165-40-49-186-23-108-18-46-137-129-145-78-25-86-127-123-112-177-54-34-42-43-149-70-75-81-90-27-164-144-15-184-160-193-41-139-68-115-118-121-97-101-26-1-152-167-178-106-185-52-55-57-92-31-196-157-16-171-175-113-44-120-2-124-94-79-80-63-53-180-133-151-109-0-143-89-183-117-159-22-146-181-116-47-65-59-176-122-189-100"
199,94292,100,45925,140217,16,"59-72-154-86-75-101-1-2-120-44-25-31-196-81-52-55-176-80-133-79-122-148-57-92-129-97-43-160-177-54-34-42-115-51-63-179-145-16-171-175-113-78-41-18-108-140-89-15-49-14-102-151-162-123-184-35-70-135-127-112-149-131-65-116-139-46-143-170-117-93-69-22-159-193-68-0-183-114-62-9-178-106-185-165-144-21-164-90-40-152-124-94-100-26-53-180-137-23-186-118"
200,91654,100,41687,133341,21,"16-171-175-113-31-81-90-165-114-23-93-108-69-18-22-34-160-54-184-84-112-4-70-154-180-97-26-167-62-9-37-49-106-185-40-145-78-25-44-101-75-59-51-137-102-138-14-144-186-143-117-140-68-118-63-1-152-124-94-122-79-133-123-149-65-43-41-193-181-127-135-86-120-82-129-57-55-15-89-183-0-46-115-139-116-5-42-151-162-72-176-80-148-178-52-92-2-100-121-53"
