SolutionID,TotalCost,NumNodes,TotalDistance,ObjectiveFunction,TotalRunningTime,Cycle
1,71579,100,23109,94688,4,"9-62-102-49-178-106-52-55-57-92-129-2-120-44-25-16-171-175-113-56-31-78-145-179-196-81-90-185-40-165-138-14-144-15-114-186-23-89-183-143-117-0-137-176-80-151-51-118-59-115-46-68-139-193-41-5-42-181-159-69-108-18-22-146-34-160-48-54-177-10-190-184-43-116-65-149-123-127-162-133-79-63-180-135-70-154-158-53-121-100-26-86-75-101-1-97-152-94-124-148"
2,71702,100,23154,94856,4,"178-49-14-144-102-62-9-148-15-114-186-23-89-183-143-117-0-137-176-80-151-51-118-59-115-46-68-139-193-41-5-42-181-159-69-108-18-22-146-34-160-48-54-177-10-190-184-43-116-65-149-123-127-162-133-79-63-180-135-70-154-158-53-121-94-124-152-97-1-101-26-100-86-75-2-129-57-92-82-120-44-25-16-171-175-113-56-31-78-145-179-196-81-90-40-165-185-55-52-106"
3,71497,100,23719,95216,4,"56-113-175-171-16-78-25-44-120-82-92-57-129-2-152-97-1-101-75-86-26-100-53-154-70-135-180-94-63-79-133-51-118-59-115-46-68-139-193-41-5-42-181-159-69-108-18-22-146-34-160-48-54-177-10-190-4-112-84-184-43-116-65-149-123-127-162-151-80-176-137-0-117-143-183-89-23-186-114-15-148-9-62-102-144-14-49-178-106-52-55-185-165-40-90-81-196-179-145-31"
4,72476,100,23498,95974,5,"199-22-146-159-193-41-139-115-5-42-181-34-160-48-54-177-10-190-84-184-43-116-65-149-123-127-162-151-133-135-70-154-180-53-121-100-26-86-75-44-25-16-171-175-113-56-31-78-145-179-196-81-90-40-165-185-106-178-3-14-144-62-9-148-102-49-52-55-92-57-129-82-120-2-101-1-97-152-124-94-63-79-80-176-137-51-59-118-46-68-0-89-183-143-117-93-140-108-69-18"
5,72086,100,23278,95364,7,"37-148-124-94-152-97-1-101-75-86-26-100-121-53-158-154-70-135-180-63-79-133-51-118-59-115-46-68-139-193-41-5-42-181-159-69-108-18-22-146-34-160-48-54-177-10-184-43-116-65-149-123-127-162-151-80-176-137-0-117-143-183-89-23-186-114-15-9-62-102-49-178-106-52-55-57-92-129-2-120-44-25-16-171-175-113-56-31-78-145-179-196-81-90-185-40-165-138-14-144"
6,71365,100,23372,94737,7,"119-40-90-165-185-55-52-106-178-49-14-144-102-62-9-148-15-114-186-137-23-89-183-143-117-0-46-68-139-193-41-115-5-42-181-159-69-108-18-22-146-34-160-48-54-177-10-190-4-112-84-184-43-116-65-59-118-51-176-80-151-162-123-127-133-79-63-94-180-135-70-154-53-100-26-86-75-101-1-97-152-2-129-57-92-82-120-44-25-16-171-175-113-56-31-78-145-179-196-81"
7,71475,100,22609,94084,5,"48-177-54-30-34-181-195-146-22-18-108-69-159-193-41-139-115-46-68-140-93-0-117-143-183-89-186-23-137-176-80-79-63-94-124-152-97-1-101-2-120-82-129-57-92-55-52-49-102-148-9-62-144-14-3-178-106-185-165-119-40-90-81-196-179-145-78-31-56-113-175-171-16-25-44-75-86-26-100-121-53-180-154-135-70-127-123-162-133-151-51-118-59-149-65-116-43-42-184-160"
8,71093,100,22888,93981,5,"137-23-186-89-183-143-117-0-46-68-139-193-41-115-5-42-181-159-69-108-18-22-146-34-160-48-54-177-10-190-4-112-84-184-43-116-65-59-118-51-151-133-162-123-127-70-135-154-180-53-121-100-26-86-75-44-25-16-171-175-113-56-31-78-145-179-196-81-90-40-165-185-106-178-3-14-144-62-9-148-102-49-52-55-92-57-129-82-120-2-101-1-97-152-124-94-63-79-80-176"
9,71420,100,22875,94295,5,"35-43-116-65-59-118-51-151-133-162-123-127-70-135-154-180-53-121-100-26-86-75-44-25-16-171-175-113-56-31-78-145-179-196-81-90-40-165-185-106-178-3-14-144-62-9-148-102-49-52-55-92-57-129-82-120-2-101-1-97-152-124-94-63-79-80-176-137-23-186-89-183-143-117-0-93-140-68-46-115-139-193-41-5-42-181-159-69-108-18-22-146-34-160-48-54-177-10-190-184"
10,71766,100,23582,95348,5,"95-164-7-21-14-144-15-114-186-23-89-183-143-117-0-137-176-80-151-162-123-149-65-116-43-184-177-54-48-160-34-146-22-18-108-69-159-181-42-5-41-193-139-68-46-115-59-118-51-133-79-63-180-135-70-154-53-121-100-26-86-75-101-1-97-152-94-124-148-9-62-102-49-178-106-52-55-57-92-129-2-120-44-25-16-171-175-113-56-31-78-145-179-196-81-185-40-165-90-27"
11,71667,100,23197,94864,4,"9-62-102-49-178-106-52-55-57-92-129-2-120-44-25-16-171-175-113-56-31-78-145-179-196-81-90-185-40-165-138-14-144-15-114-186-23-89-183-143-117-0-137-176-80-151-162-127-123-149-65-116-43-184-190-10-177-54-48-160-34-146-22-18-108-69-159-181-42-5-41-193-139-68-46-115-59-118-51-133-79-63-180-135-70-154-158-53-121-100-26-86-75-101-1-97-152-94-124-148"
12,72476,100,23498,95974,6,"199-18-69-108-140-93-117-143-183-89-0-68-46-118-59-51-137-176-80-79-63-94-124-152-97-1-101-2-120-82-129-57-92-55-52-49-102-148-9-62-144-14-3-178-106-185-165-40-90-81-196-179-145-78-31-56-113-175-171-16-25-44-75-86-26-100-121-53-180-154-70-135-133-151-162-127-123-149-65-116-43-184-84-190-10-177-54-48-160-34-181-42-5-115-139-41-193-159-146-22"
13,70484,100,22384,92868,5,"51-151-133-162-123-127-70-135-154-180-53-121-100-26-86-75-44-25-16-171-175-113-56-31-78-145-179-196-81-90-40-165-185-106-178-3-14-144-62-9-148-102-49-52-55-57-92-129-82-120-2-101-1-97-152-124-94-63-79-80-176-137-23-186-89-183-143-117-0-46-68-139-115-41-193-159-69-108-18-22-146-181-34-160-48-54-177-10-190-4-112-84-35-184-42-43-116-65-59-118"
14,71293,100,22793,94086,4,"184-84-190-10-177-54-48-160-34-146-22-18-108-69-159-181-42-5-41-193-139-115-46-68-140-93-0-117-143-183-89-186-23-137-176-80-79-63-94-124-152-97-1-101-2-120-82-129-57-92-55-52-49-102-148-9-62-144-14-3-178-106-185-165-40-90-81-196-179-145-78-31-56-113-175-171-16-25-44-75-86-26-100-121-53-180-154-135-70-127-123-162-133-151-51-118-59-65-116-43"
15,71775,100,22967,94742,8,"37-9-62-102-49-178-106-52-55-57-92-129-2-120-44-25-16-171-175-113-56-31-78-145-179-196-81-90-165-40-185-138-14-144-15-114-186-23-89-183-143-117-0-137-176-80-151-51-118-59-115-46-68-139-193-41-5-42-181-159-69-108-18-22-146-34-160-48-54-177-10-184-43-116-65-149-123-127-162-133-79-63-180-135-70-154-158-53-121-100-26-86-75-101-1-97-152-94-124-148"
16,72114,100,23110,95224,5,"56-113-175-171-16-78-145-179-92-57-129-82-25-44-120-2-152-97-1-101-75-86-26-100-53-154-70-135-180-94-63-79-133-51-118-59-115-46-68-139-193-41-5-42-181-159-69-108-18-22-146-34-160-48-54-177-184-43-116-65-149-123-162-151-80-176-137-0-117-143-183-89-23-186-114-15-148-9-62-144-14-49-178-106-52-55-185-40-165-39-95-7-164-58-27-90-81-196-157-31"
17,72589,100,23611,96200,6,"69-108-18-199-22-146-159-193-41-139-115-5-42-181-34-160-48-54-177-10-190-84-184-43-116-65-149-123-127-162-151-133-135-70-154-180-53-121-100-26-86-75-44-25-16-171-175-113-56-31-78-145-179-196-81-90-40-165-185-106-178-3-14-144-62-9-148-102-49-52-55-92-57-129-82-120-2-101-1-97-152-124-94-63-79-80-176-137-51-59-118-46-68-0-89-183-143-117-93-140"
18,71734,100,23611,95345,4,"123-149-65-116-59-118-115-43-184-84-4-112-10-177-54-48-160-34-146-22-18-108-69-159-181-42-5-41-193-139-68-46-0-117-143-183-89-186-23-137-176-80-51-151-162-133-79-63-94-124-152-97-1-101-2-120-82-129-57-92-55-52-49-102-148-9-62-144-14-3-178-106-185-165-40-90-81-196-179-145-78-31-56-113-175-171-16-25-44-75-86-26-100-121-53-180-154-135-70-127"
19,71656,100,23533,95189,6,"127-123-149-65-116-59-118-115-43-184-84-112-4-10-177-54-48-160-34-146-22-18-108-69-159-181-42-5-41-193-139-68-46-0-117-143-183-89-186-23-137-176-80-51-151-162-133-79-63-94-124-152-97-1-101-2-120-82-129-57-92-55-52-49-102-148-9-62-144-14-3-178-106-185-165-40-90-81-196-179-145-78-31-56-113-175-171-16-25-44-75-86-26-100-121-53-180-154-135-70"
20,71331,100,23580,94911,4,"157-196-81-90-40-165-185-55-52-106-178-49-14-144-102-62-9-148-15-114-186-23-89-183-143-117-0-137-176-80-51-118-59-115-46-68-139-193-41-5-42-181-159-69-108-18-22-146-34-160-48-54-177-10-190-4-112-84-184-43-116-65-149-123-127-162-151-133-79-63-94-180-135-70-154-53-100-26-86-75-101-1-97-152-2-120-44-25-16-171-175-113-56-31-78-145-92-129-57-179"
21,72051,100,23801,95852,6,"22-146-159-193-41-139-115-5-42-181-34-160-48-54-177-10-4-112-84-184-43-116-65-149-123-127-162-151-133-135-70-154-180-53-121-100-26-86-75-44-25-16-171-175-113-56-31-78-145-179-196-81-90-40-165-185-106-178-3-14-144-62-9-148-102-49-52-55-92-57-129-82-120-2-101-1-97-152-124-94-63-79-80-176-137-51-59-118-46-68-0-89-183-143-117-93-140-108-69-18"
22,72017,100,23461,95478,6,"29-127-123-149-65-43-116-59-118-51-151-133-162-135-70-154-180-53-121-100-26-86-75-44-25-16-171-175-113-56-31-78-145-179-196-81-90-40-165-185-106-178-3-14-144-62-9-148-102-49-52-55-92-57-129-120-2-101-1-97-152-124-94-63-79-80-176-137-23-89-183-143-117-0-93-140-68-46-115-139-193-41-42-181-159-69-108-18-22-146-34-160-48-54-177-184-35-84-4-112"
23,71991,100,22987,94978,8,"56-113-175-171-16-78-145-179-57-92-129-82-25-44-120-2-152-97-1-101-75-86-26-100-53-154-70-135-180-94-63-79-133-162-123-149-65-116-43-184-177-54-48-160-34-146-22-18-108-69-159-181-42-5-41-193-139-68-46-115-59-118-51-151-80-176-137-0-117-143-183-89-23-186-114-15-148-9-62-144-14-49-178-106-52-55-185-40-165-39-95-7-164-58-27-90-81-196-157-31"
24,71057,100,23436,94493,4,"179-196-81-90-165-40-185-55-52-106-178-49-14-144-102-62-9-148-15-114-186-23-89-183-143-117-0-137-176-80-151-162-127-123-149-65-116-43-184-35-84-112-4-190-10-177-54-48-160-34-146-22-18-108-69-159-181-42-5-41-193-139-68-46-115-59-118-51-133-79-63-94-180-135-70-154-53-100-26-86-75-101-1-97-152-2-120-44-25-16-171-175-113-56-31-78-145-92-129-57"
25,71041,100,22836,93877,5,"183-143-117-0-46-68-139-115-41-193-5-42-181-159-69-108-18-22-146-34-160-48-54-177-10-190-4-112-84-184-43-116-65-59-118-51-151-133-162-123-127-70-135-154-180-53-121-100-26-86-75-44-25-16-171-175-113-56-31-78-145-179-196-81-90-40-165-185-106-178-3-14-144-62-9-148-102-49-52-55-92-57-129-82-120-2-101-1-97-152-124-94-63-79-80-176-137-23-186-89"
26,71687,100,22988,94675,4,"64-114-186-23-89-183-143-117-0-46-68-139-193-41-115-5-42-181-159-69-108-18-22-146-34-160-48-54-177-10-112-4-84-184-43-116-65-59-118-51-151-133-162-123-127-70-135-154-180-53-121-94-63-79-80-176-137-148-9-62-102-49-178-106-52-55-57-92-129-2-152-97-1-101-26-100-86-75-120-44-25-16-171-175-113-56-31-78-145-179-196-81-90-185-40-165-138-14-144-15"
27,71861,100,23148,95009,4,"88-171-175-113-56-31-78-145-179-196-81-90-165-40-185-55-52-106-178-49-14-144-102-62-9-148-15-114-186-23-89-183-143-117-0-137-176-80-51-118-59-115-46-68-139-193-41-5-42-181-159-69-108-18-22-146-34-160-48-54-177-10-4-112-84-184-43-116-65-149-123-127-162-151-133-79-63-94-180-135-70-154-53-100-26-86-75-101-1-97-152-2-129-57-92-82-120-44-25-16"
28,72047,100,23797,95844,5,"108-69-18-22-146-159-193-41-139-115-5-42-181-34-160-48-54-177-10-190-4-112-184-43-116-65-149-123-127-162-151-133-135-70-154-180-53-121-100-26-86-75-44-25-16-171-175-113-56-31-78-145-179-196-81-90-40-165-185-106-178-3-14-144-62-9-148-102-49-52-55-92-57-129-82-120-2-101-1-97-152-124-94-63-79-80-176-137-51-59-118-46-68-0-89-183-143-117-93-140"
29,72260,100,23550,95810,4,"167-2-120-44-25-16-171-175-113-56-31-78-145-179-92-129-57-55-52-185-40-196-81-90-27-39-165-106-178-49-14-144-102-62-9-15-114-186-23-89-183-143-117-0-137-176-80-151-162-127-123-149-65-116-43-184-177-54-48-160-34-146-22-18-108-69-159-181-42-5-41-193-139-68-46-115-59-118-51-133-79-63-180-135-70-154-158-53-121-100-26-86-75-101-1-97-152-94-124-148"
30,72076,100,23636,95712,5,"55-52-185-40-196-81-90-27-58-164-7-95-39-165-106-178-49-14-144-102-62-9-148-15-114-186-23-89-183-143-117-0-137-176-80-151-162-127-123-149-65-116-43-184-177-54-48-160-34-146-22-18-108-69-159-181-42-5-41-193-139-68-46-115-59-118-51-133-79-63-94-180-135-70-154-53-100-26-86-75-101-1-97-152-2-120-44-25-16-171-175-113-56-31-78-145-179-92-129-57"
31,71293,100,22793,94086,4,"184-84-190-10-177-54-48-160-34-146-22-18-108-69-159-181-42-5-41-193-139-115-46-68-140-93-0-117-143-183-89-186-23-137-176-80-79-63-94-124-152-97-1-101-2-120-82-129-57-92-55-52-49-102-148-9-62-144-14-3-178-106-185-165-40-90-81-196-179-145-78-31-56-113-175-171-16-25-44-75-86-26-100-121-53-180-154-135-70-127-123-162-133-151-51-118-59-65-116-43"
32,72270,100,24020,96290,5,"46-115-59-118-51-137-176-80-79-63-94-124-152-97-1-101-2-120-82-129-57-92-55-52-49-102-148-9-62-144-14-3-178-106-185-165-40-90-81-196-179-145-78-31-56-113-175-171-16-25-44-75-86-26-100-121-53-180-154-70-135-133-151-162-127-123-149-65-116-43-184-84-112-4-10-177-54-48-160-34-146-22-18-108-69-159-181-42-5-41-193-139-68-140-93-117-143-183-89-0"
33,71384,100,23309,94693,4,"121-53-158-154-70-135-180-63-79-80-176-51-151-133-162-127-123-149-59-65-116-43-42-184-84-4-112-10-177-54-48-160-34-181-146-22-18-108-69-159-193-41-115-139-68-46-0-117-143-183-89-23-137-186-114-15-9-62-144-14-138-165-40-185-90-81-196-179-145-78-31-56-113-175-171-16-25-44-120-2-129-92-57-55-52-106-178-49-102-148-124-94-152-1-101-75-86-97-26-100"
34,72061,100,23674,95735,6,"58-164-7-21-144-15-114-186-23-89-183-143-117-0-137-176-80-151-162-123-149-65-116-43-184-177-54-48-160-34-146-22-18-108-69-159-181-42-41-193-139-68-46-115-59-118-51-133-79-63-180-135-70-154-53-121-100-26-86-75-101-1-97-152-94-124-148-9-62-102-49-14-178-106-52-55-57-92-129-2-120-44-25-16-171-175-113-56-31-78-145-179-196-81-185-40-165-90-27-95"
35,71764,100,22927,94691,4,"81-90-27-58-164-7-95-39-165-40-185-55-52-106-178-49-14-144-102-62-9-148-15-114-186-23-89-183-143-117-0-137-176-80-51-118-59-115-46-68-139-193-41-5-42-181-159-69-108-18-22-146-34-160-48-54-177-184-43-116-65-149-123-162-151-133-79-63-94-180-135-70-154-53-100-26-86-75-101-1-97-152-2-129-57-92-82-120-44-25-16-171-175-113-56-31-78-145-179-196"
36,71185,100,23110,94295,4,"100-121-53-158-154-70-135-180-63-79-80-176-51-151-133-162-127-123-149-59-65-116-43-42-184-112-4-190-10-177-54-48-160-34-181-146-22-18-108-69-159-193-41-115-139-68-46-0-117-143-183-89-23-137-186-114-15-9-62-144-14-138-165-40-185-90-81-196-179-145-78-31-56-113-175-171-16-25-44-120-2-129-92-57-55-52-106-178-49-102-148-124-94-152-97-1-101-75-86-26"
37,72312,100,24023,96335,4,"82-44-120-2-152-97-1-101-75-86-26-100-53-154-70-135-180-94-63-79-133-51-118-59-115-46-68-139-193-41-5-42-181-159-69-108-18-22-146-34-160-48-54-177-184-43-116-65-149-123-127-162-151-80-176-137-0-117-143-183-89-23-186-114-15-148-9-62-102-144-14-49-178-106-165-39-95-7-164-27-90-81-196-40-185-52-55-57-129-92-179-145-78-31-56-113-175-171-16-25"
38,71703,100,23100,94803,7,"119-40-185-165-138-14-144-15-114-186-23-89-183-143-117-0-137-176-80-151-162-127-123-149-65-116-43-184-10-177-54-48-160-34-146-22-18-108-69-159-181-42-5-41-193-139-68-46-115-59-118-51-133-79-63-180-135-70-154-158-53-121-100-26-86-75-101-1-97-152-94-124-148-9-62-102-49-178-106-52-55-57-92-129-2-120-44-25-16-171-175-113-56-31-78-145-179-196-81-90"
39,72275,100,23962,96237,5,"21-144-15-114-186-23-89-183-143-117-0-137-176-80-151-162-127-123-149-65-116-43-184-10-177-54-48-160-34-146-22-18-108-69-159-181-42-5-41-193-139-68-46-115-59-118-51-133-79-63-180-135-70-154-158-53-121-100-26-86-75-101-1-97-152-94-124-148-9-62-102-49-178-106-52-55-57-92-129-2-120-44-25-16-171-175-113-56-31-78-145-179-196-81-90-185-40-165-138-14"
40,72166,100,23916,96082,5,"69-18-108-140-93-117-143-183-89-0-68-46-118-59-51-137-176-80-79-63-94-124-152-97-1-101-2-120-82-129-57-92-55-52-49-102-148-9-62-144-14-3-178-106-185-165-40-90-81-196-179-145-78-31-56-113-175-171-16-25-44-75-86-26-100-121-53-180-154-70-135-133-151-162-127-123-149-65-116-43-184-84-112-4-10-177-54-48-160-34-181-42-5-115-139-41-193-159-146-22"
41,71790,100,23242,95032,4,"178-49-14-144-102-62-9-148-15-114-186-23-89-183-143-117-0-137-176-80-151-162-127-123-149-65-116-43-184-190-10-177-54-48-160-34-146-22-18-108-69-159-181-42-5-41-193-139-68-46-115-59-118-51-133-79-63-180-135-70-154-158-53-121-94-124-152-97-1-101-26-100-86-75-2-129-57-92-82-120-44-25-16-171-175-113-56-31-78-145-179-196-81-90-40-165-185-55-52-106"
42,71267,100,23192,94459,5,"86-26-100-121-53-158-154-70-135-180-63-79-80-176-51-151-133-162-127-123-149-59-65-116-43-42-184-84-4-112-10-177-54-48-160-34-181-146-22-18-108-69-159-193-41-115-139-68-46-0-117-143-183-89-23-137-186-114-15-9-62-144-14-138-165-40-185-90-81-196-179-145-78-31-56-113-175-171-16-25-44-120-2-129-92-57-55-52-106-178-49-102-148-124-94-152-97-1-101-75"
43,71701,100,23748,95449,7,"157-78-145-179-196-81-90-40-165-185-55-52-106-178-49-14-144-102-62-9-148-15-114-186-23-89-183-143-117-0-137-176-80-151-162-127-123-149-65-116-43-184-84-112-4-10-177-54-48-160-34-146-22-18-108-69-159-181-42-5-41-193-139-68-46-115-59-118-51-133-79-63-94-180-135-70-154-53-100-26-86-75-101-1-97-152-2-129-57-92-82-120-44-25-16-171-175-113-56-31"
44,71885,100,23101,94986,5,"27-58-164-7-95-39-165-106-178-14-49-102-144-62-9-148-15-114-186-137-23-89-183-143-117-0-46-68-139-115-41-193-159-69-108-18-22-146-181-34-160-48-54-177-184-42-43-116-65-59-149-123-127-162-133-151-51-176-80-79-94-63-180-135-70-154-158-53-121-100-26-86-75-101-1-97-152-2-120-44-25-16-171-175-113-56-31-78-145-179-92-129-57-55-52-185-40-196-81-90"
45,71790,100,23273,95063,4,"185-55-52-106-178-49-14-144-102-62-9-148-15-114-186-23-89-183-143-117-0-137-176-80-151-162-127-123-149-65-116-43-184-84-190-10-177-54-48-160-34-146-22-18-108-69-159-181-42-5-41-193-139-68-46-115-59-118-51-133-79-94-63-180-135-70-154-158-53-121-100-26-86-75-101-1-97-152-2-129-57-92-82-120-44-25-16-171-175-113-56-31-78-145-179-196-81-90-40-165"
46,71610,100,23472,95082,5,"112-127-123-149-65-43-116-59-118-51-151-133-162-135-70-154-180-53-121-100-26-86-75-44-25-16-171-175-113-56-31-78-145-179-196-81-90-40-165-185-106-178-3-14-144-62-9-148-102-49-52-55-92-57-129-120-2-101-1-97-152-124-94-63-79-80-176-137-23-89-183-143-117-0-93-140-68-46-115-139-193-41-5-42-181-159-69-108-18-22-146-34-160-48-54-177-184-35-84-4"
47,71190,100,22645,93835,6,"35-43-116-65-59-118-51-151-133-162-123-127-70-135-154-180-53-121-100-26-86-75-44-25-16-171-175-113-56-31-78-145-179-196-81-90-40-165-185-106-178-3-14-144-62-9-148-102-49-52-55-92-57-129-82-120-2-101-1-97-152-124-94-63-79-80-176-137-23-186-89-183-143-0-117-93-140-68-46-115-139-193-41-5-42-181-159-69-108-18-22-146-34-160-48-54-177-10-190-184"
48,72008,100,23200,95208,5,"37-148-124-94-152-97-1-101-75-86-26-100-121-53-158-154-70-135-180-63-79-133-51-118-59-115-46-68-139-193-41-5-42-181-159-69-108-18-22-146-34-160-48-54-177-10-184-43-116-65-149-123-127-162-151-80-176-137-0-117-143-183-89-23-186-114-15-102-49-178-106-52-55-57-92-129-2-120-44-25-16-171-175-113-56-31-78-145-179-196-81-90-40-185-165-138-14-144-62-9"
49,71321,100,23025,94346,7,"114-89-183-143-117-0-46-68-139-193-41-115-5-42-181-159-69-108-18-22-146-34-160-48-54-177-10-4-112-84-184-43-116-65-59-118-51-151-133-162-123-127-70-135-154-180-53-121-100-26-86-75-44-25-16-171-175-113-56-31-78-145-179-196-81-90-165-40-185-106-178-3-14-144-62-9-148-102-49-52-55-92-57-129-82-120-2-101-1-97-152-124-94-63-79-80-176-137-23-186"
50,71185,100,23110,94295,4,"26-100-121-53-158-154-70-135-180-63-79-80-176-51-151-133-162-127-123-149-59-65-116-43-42-184-112-4-190-10-177-54-48-160-34-181-146-22-18-108-69-159-193-41-115-139-68-46-0-117-143-183-89-23-137-186-114-15-9-62-144-14-138-165-40-185-90-81-196-179-145-78-31-56-113-175-171-16-25-44-120-2-129-92-57-55-52-106-178-49-102-148-124-94-152-97-1-101-75-86"
51,71290,100,23512,94802,4,"145-78-31-56-113-175-171-16-25-44-120-82-92-57-129-2-152-97-1-101-75-86-26-100-53-154-70-135-180-94-63-79-133-51-118-59-115-46-68-139-193-41-5-42-181-159-69-108-18-22-146-34-160-48-54-177-10-190-4-112-84-184-43-116-65-149-123-127-162-151-80-176-137-0-117-143-183-89-23-186-114-15-148-9-62-102-144-14-49-178-106-52-55-185-165-40-90-81-196-179"
52,72107,100,23408,95515,8,"158-154-135-70-127-123-149-65-116-59-118-115-43-184-84-190-10-177-54-48-160-34-146-22-18-108-69-159-181-42-5-41-193-139-68-46-0-117-143-183-89-186-23-137-176-80-51-151-162-133-79-63-94-124-152-97-1-101-2-120-82-129-57-92-55-52-49-102-148-9-62-144-14-3-178-106-185-165-40-90-81-196-179-145-78-31-56-113-175-171-16-25-44-75-86-26-100-121-53-180"
53,71584,100,23611,95195,6,"118-151-80-79-63-94-124-152-97-1-101-2-120-44-25-16-171-175-113-56-31-78-145-179-196-81-90-40-165-185-106-178-3-14-144-62-9-148-102-49-52-55-57-92-129-82-75-86-26-100-121-53-180-154-70-135-133-162-127-123-149-59-65-116-43-42-184-84-112-4-190-10-177-54-48-160-34-181-146-22-18-108-69-159-193-41-115-139-68-46-0-117-143-183-89-186-23-137-176-51"
54,71656,100,23533,95189,5,"135-154-180-53-121-100-26-86-75-44-25-16-171-175-113-56-31-78-145-179-196-81-90-40-165-185-106-178-3-14-144-62-9-148-102-49-52-55-92-57-129-82-120-2-101-1-97-152-124-94-63-79-133-162-151-51-80-176-137-23-186-89-183-143-117-0-46-68-139-193-41-5-42-181-159-69-108-18-22-146-34-160-48-54-177-10-4-112-84-184-43-115-118-59-116-65-149-123-127-70"
55,71960,100,23210,95170,5,"3-49-14-144-102-62-9-148-15-114-186-23-89-183-143-117-0-137-176-80-151-162-127-123-149-65-116-43-184-10-177-54-48-160-34-146-22-18-108-69-159-181-42-5-41-193-139-68-46-115-59-118-51-133-79-63-180-135-70-154-158-53-121-94-124-152-97-1-101-26-100-86-75-2-129-57-92-82-120-44-25-16-171-175-113-56-31-78-145-179-196-81-90-40-165-185-55-52-106-178"
56,72657,100,23731,96388,4,"198-115-59-118-51-137-176-80-79-63-94-124-152-97-1-101-2-120-82-129-57-92-55-52-49-102-148-9-62-144-14-3-178-106-185-165-40-90-81-196-179-145-78-31-56-113-175-171-16-25-44-75-86-26-100-121-53-180-154-70-135-133-151-162-127-123-149-65-116-43-184-84-190-10-177-54-48-160-34-146-22-18-108-69-159-181-42-5-41-193-139-68-140-93-117-143-183-89-0-46"
57,72192,100,23752,95944,4,"75-101-1-152-97-26-100-86-53-154-70-135-180-94-63-79-133-51-118-59-115-46-68-139-193-41-5-42-181-159-69-108-18-22-146-34-160-48-54-177-184-43-116-65-149-123-127-162-151-80-176-137-0-117-143-183-89-23-186-114-15-148-9-62-102-144-14-49-178-106-165-39-95-7-164-58-27-90-81-196-40-185-52-55-57-129-92-179-145-78-31-56-113-175-171-16-25-44-120-2"
58,71701,100,23748,95449,7,"157-78-145-179-196-81-90-40-165-185-55-52-106-178-49-14-144-102-62-9-148-15-114-186-23-89-183-143-117-0-137-176-80-151-162-127-123-149-65-116-43-184-84-112-4-10-177-54-48-160-34-146-22-18-108-69-159-181-42-5-41-193-139-68-46-115-59-118-51-133-79-63-94-180-135-70-154-53-100-26-86-75-101-1-97-152-2-129-57-92-82-120-44-25-16-171-175-113-56-31"
59,71667,100,23197,94864,4,"102-49-178-106-52-55-57-92-129-2-120-44-25-16-171-175-113-56-31-78-145-179-196-81-90-185-40-165-138-14-144-15-114-186-23-89-183-143-117-0-137-176-80-151-162-127-123-149-65-116-43-184-190-10-177-54-48-160-34-146-22-18-108-69-159-181-42-5-41-193-139-68-46-115-59-118-51-133-79-63-180-135-70-154-158-53-121-100-26-86-75-101-1-97-152-94-124-148-9-62"
60,71667,100,23197,94864,4,"144-15-114-186-23-89-183-143-117-0-137-176-80-151-162-127-123-149-65-116-43-184-190-10-177-54-48-160-34-146-22-18-108-69-159-181-42-5-41-193-139-68-46-115-59-118-51-133-79-63-180-135-70-154-158-53-121-100-26-86-75-101-1-97-152-94-124-148-9-62-102-49-178-106-52-55-57-92-129-2-120-44-25-16-171-175-113-56-31-78-145-179-196-81-90-185-40-165-138-14"
61,71093,100,22888,93981,7,"80-176-137-23-186-89-183-143-117-0-46-68-139-193-41-115-5-42-181-159-69-108-18-22-146-34-160-48-54-177-10-190-4-112-84-184-43-116-65-59-118-51-151-133-162-123-127-70-135-154-180-53-121-100-26-86-75-44-25-16-171-175-113-56-31-78-145-179-196-81-90-40-165-185-106-178-3-14-144-62-9-148-102-49-52-55-92-57-129-82-120-2-101-1-97-152-124-94-63-79"
62,72476,100,23498,95974,5,"199-18-69-108-140-93-117-143-183-89-0-68-46-118-59-51-137-176-80-79-63-94-124-152-97-1-101-2-120-82-129-57-92-55-52-49-102-148-9-62-144-14-3-178-106-185-165-40-90-81-196-179-145-78-31-56-113-175-171-16-25-44-75-86-26-100-121-53-180-154-70-135-133-151-162-127-123-149-65-116-43-184-84-190-10-177-54-48-160-34-181-42-5-115-139-41-193-159-146-22"
63,71772,100,23195,94967,5,"124-94-152-97-1-101-75-86-26-100-121-53-158-154-70-135-180-63-79-80-176-51-151-133-162-127-123-149-59-65-116-43-184-84-190-10-177-54-48-160-34-146-22-18-108-69-159-181-42-5-115-41-193-139-68-46-0-117-143-183-89-23-137-186-114-15-9-62-144-14-138-165-40-185-90-81-196-179-145-78-31-56-113-175-171-16-25-44-120-2-129-92-57-55-52-106-178-49-102-148"
64,71605,100,23135,94740,4,"165-185-40-90-81-196-179-145-78-31-56-113-175-171-16-25-44-120-2-129-92-57-55-52-106-178-49-102-62-9-148-124-94-152-97-1-101-75-86-26-100-121-53-158-154-70-135-180-63-79-133-51-118-59-115-46-68-139-193-41-5-42-181-159-69-108-18-22-146-34-160-48-54-177-10-190-184-43-116-65-149-123-127-162-151-80-176-137-0-117-143-183-89-23-186-114-15-144-14-138"
65,70685,100,22585,93270,4,"118-59-65-116-43-42-184-35-84-112-4-190-10-177-54-48-160-34-181-146-22-18-108-69-159-193-41-115-139-68-46-0-117-143-183-89-186-23-137-176-80-79-63-94-124-152-97-1-101-2-120-82-129-57-92-55-52-49-102-148-9-62-144-14-3-178-106-185-165-40-90-81-196-179-145-78-31-56-113-175-171-16-25-44-75-86-26-100-121-53-180-154-135-70-127-123-162-133-151-51"
66,71647,100,23524,95171,5,"180-53-121-100-26-86-75-82-129-57-92-55-52-49-102-148-9-62-144-14-3-178-106-185-165-40-90-81-196-179-145-78-31-56-113-175-171-16-25-44-120-2-101-1-97-152-124-94-63-79-133-162-151-51-80-176-137-23-186-89-183-143-117-0-46-68-139-193-41-5-42-181-159-69-108-18-22-146-34-160-48-54-177-10-190-4-112-184-43-115-118-59-116-65-149-123-127-70-135-154"
67,72762,100,24458,97220,5,"167-152-2-1-97-26-100-101-75-86-53-154-70-135-180-94-63-79-133-51-118-59-115-46-68-139-193-41-5-42-181-159-69-108-18-22-146-34-160-48-54-177-184-43-116-65-149-123-127-162-151-80-176-137-0-117-143-183-89-23-186-114-15-148-9-62-102-144-14-49-178-106-165-39-95-164-27-90-81-196-40-185-52-55-57-92-179-145-78-31-56-113-175-171-16-25-44-120-82-129"
68,72454,100,23675,96129,9,"124-94-152-97-1-101-2-120-44-25-16-171-175-113-56-31-78-145-179-57-92-129-82-75-86-26-100-121-53-158-154-70-135-180-63-79-80-176-51-133-151-162-127-123-149-59-65-116-43-184-190-10-177-54-48-160-34-146-22-18-108-69-159-181-42-5-193-41-115-139-68-46-0-117-143-183-89-23-137-186-114-15-9-62-144-14-138-165-90-81-196-40-185-55-52-106-178-49-102-148"
69,71550,100,23080,94630,4,"102-49-178-106-52-55-57-92-129-2-120-44-25-16-171-175-113-56-31-78-145-179-196-81-90-165-40-185-138-14-144-15-114-186-23-89-183-143-117-0-137-176-80-151-162-127-123-149-65-116-43-184-190-10-177-54-48-160-34-146-22-18-108-69-159-181-42-5-41-193-139-68-46-115-59-118-51-133-79-63-180-135-70-154-158-53-121-100-26-86-75-101-1-97-152-94-124-148-9-62"
70,71185,100,23110,94295,4,"124-94-152-97-1-101-75-86-26-100-121-53-158-154-70-135-180-63-79-80-176-51-151-133-162-127-123-149-59-65-116-43-42-184-112-4-190-10-177-54-48-160-34-181-146-22-18-108-69-159-193-41-115-139-68-46-0-117-143-183-89-23-137-186-114-15-9-62-144-14-138-165-40-185-90-81-196-179-145-78-31-56-113-175-171-16-25-44-120-2-129-92-57-55-52-106-178-49-102-148"
71,71041,100,22836,93877,6,"151-133-162-123-127-70-135-154-180-53-121-100-26-86-75-44-25-16-171-175-113-56-31-78-145-179-196-81-90-40-165-185-106-178-3-14-144-62-9-148-102-49-52-55-92-57-129-82-120-2-101-1-97-152-124-94-63-79-80-176-137-23-186-89-183-143-117-0-46-68-139-115-41-193-5-42-181-159-69-108-18-22-146-34-160-48-54-177-10-190-4-112-84-184-43-116-65-59-118-51"
72,70983,100,22923,93906,4,"2-152-97-1-101-75-86-26-100-53-158-154-70-135-180-94-63-79-80-176-51-151-133-162-127-123-149-59-118-65-116-43-42-184-35-84-112-4-190-10-177-54-48-160-34-181-195-146-22-18-108-69-159-193-41-115-139-68-46-0-117-143-183-89-186-23-137-148-9-62-102-144-14-49-178-106-52-55-185-165-40-90-81-196-179-145-78-31-56-113-175-171-16-25-44-120-82-92-57-129"
73,72097,100,23170,95267,5,"74-152-97-1-101-75-86-26-100-53-154-70-135-180-94-63-79-80-176-51-151-133-162-127-123-149-59-65-116-43-42-184-84-190-10-177-54-48-160-34-181-146-22-18-108-69-159-193-41-115-139-68-46-0-117-143-183-89-186-23-137-148-9-62-102-144-14-49-178-106-165-39-95-7-164-58-27-90-81-196-40-185-52-55-57-129-92-179-145-78-31-56-113-175-171-16-25-44-120-2"
74,71803,100,23703,95506,4,"159-193-41-139-68-140-93-117-143-183-89-0-46-115-59-118-51-137-176-80-79-63-94-124-152-97-1-101-2-120-82-129-57-92-55-52-49-102-148-9-62-144-14-3-178-106-185-165-40-90-81-196-179-145-78-31-56-113-175-171-16-25-44-75-86-26-100-121-53-180-154-70-135-133-151-162-127-123-149-65-116-43-42-184-84-112-4-190-10-177-54-48-160-34-181-146-22-18-108-69"
75,71667,100,23197,94864,4,"138-14-144-15-114-186-23-89-183-143-117-0-137-176-80-151-162-127-123-149-65-116-43-184-190-10-177-54-48-160-34-146-22-18-108-69-159-181-42-5-41-193-139-68-46-115-59-118-51-133-79-63-180-135-70-154-158-53-121-100-26-86-75-101-1-97-152-94-124-148-9-62-102-49-178-106-52-55-57-92-129-2-120-44-25-16-171-175-113-56-31-78-145-179-196-81-90-185-40-165"
76,70840,100,22635,93475,6,"133-162-123-127-70-135-154-180-53-121-100-26-86-75-44-25-16-171-175-113-56-31-78-145-179-196-81-90-40-165-185-106-178-3-14-144-62-9-148-102-49-52-55-57-92-129-82-120-2-101-1-97-152-124-94-63-79-80-176-137-23-186-89-183-143-117-0-46-68-139-115-41-193-5-42-181-159-69-108-18-22-146-34-160-48-54-177-10-190-4-112-84-184-43-116-65-59-118-51-151"
77,71396,100,22967,94363,6,"158-180-154-135-70-127-123-162-133-151-51-118-59-65-116-43-184-112-4-190-10-177-54-48-160-34-146-22-18-108-69-159-181-42-5-115-41-193-139-68-46-0-117-143-183-89-186-23-137-176-80-79-63-94-124-152-2-120-82-129-57-92-55-52-49-102-148-9-62-144-14-3-178-106-185-165-40-90-81-196-179-145-78-31-56-113-175-171-16-25-44-75-86-1-101-97-26-100-121-53"
78,72411,100,23321,95732,6,"119-40-90-81-196-179-145-78-31-56-113-175-171-16-25-44-120-82-92-57-129-2-152-97-1-101-75-86-26-100-121-53-154-70-135-180-63-94-79-80-176-51-151-133-162-123-149-59-65-116-43-42-184-177-54-48-160-34-181-146-22-18-108-69-159-193-41-115-139-68-46-0-117-143-183-89-23-137-186-114-15-148-9-62-102-144-14-49-178-106-52-55-185-165-39-95-7-164-58-27"
79,71575,100,22853,94428,4,"189-152-97-1-101-75-86-26-100-121-53-158-154-70-135-180-63-79-80-176-51-151-133-162-127-123-149-59-65-116-43-42-184-84-190-10-177-54-48-160-34-181-146-22-18-108-69-159-193-41-115-139-68-46-0-117-143-183-89-23-137-186-114-15-9-62-144-14-138-165-40-185-90-81-196-179-145-78-31-56-113-175-171-16-25-44-120-2-129-92-57-55-52-106-178-49-102-148-124-94"
80,70830,100,22857,93687,7,"149-65-116-59-118-51-151-133-162-123-127-70-135-154-180-53-121-100-26-86-75-44-25-16-171-175-113-56-31-78-145-179-196-81-90-40-165-185-106-178-3-14-144-62-9-148-102-49-52-55-92-57-129-82-120-2-101-1-97-152-124-94-63-79-80-176-137-23-186-89-183-143-117-0-46-68-139-115-41-193-159-69-108-18-22-146-181-34-160-48-54-177-10-190-4-112-84-184-42-43"
81,71687,100,22988,94675,4,"64-114-186-23-89-183-143-117-0-46-68-139-193-41-115-5-42-181-159-69-108-18-22-146-34-160-48-54-177-10-112-4-84-184-43-116-65-59-118-51-151-133-162-123-127-70-135-154-180-53-121-94-63-79-80-176-137-148-9-62-102-49-178-106-52-55-57-92-129-2-152-97-1-101-26-100-86-75-120-44-25-16-171-175-113-56-31-78-145-179-196-81-90-185-40-165-138-14-144-15"
82,70580,100,22582,93162,5,"34-181-146-22-18-108-69-159-193-41-139-115-46-68-140-93-117-0-143-183-89-186-23-137-176-80-79-63-94-124-152-97-1-101-2-120-82-129-57-92-55-52-49-102-148-9-62-144-14-3-178-106-185-165-40-90-81-196-179-145-78-31-56-113-175-171-16-25-44-75-86-26-100-121-53-180-154-135-70-127-123-162-133-151-51-118-59-65-116-43-42-184-84-112-4-10-177-54-48-160"
83,72201,100,23951,96152,5,"68-139-193-41-5-42-181-159-69-108-18-22-146-34-160-48-54-177-10-112-4-84-184-43-116-65-149-123-127-162-151-133-135-70-154-180-53-121-100-26-86-75-44-25-16-171-175-113-56-31-78-145-179-196-81-90-165-40-185-106-178-3-14-144-62-9-148-102-49-52-55-92-57-129-82-120-2-101-1-97-152-124-94-63-79-80-176-137-51-118-59-115-46-0-89-183-143-117-93-140"
84,72471,100,23493,95964,7,"199-18-69-108-140-93-117-143-183-89-0-68-46-118-59-51-137-176-80-79-63-94-124-152-97-1-101-2-120-44-25-16-171-175-113-56-31-78-145-179-196-81-90-40-165-185-106-178-3-14-144-62-9-148-102-49-52-55-92-57-129-82-75-86-26-100-121-53-180-154-70-135-133-151-162-127-123-149-65-116-43-184-84-190-10-177-54-48-160-34-181-42-5-115-139-41-193-159-146-22"
85,71000,100,22908,93908,5,"30-54-48-160-34-181-146-22-18-108-69-159-193-41-139-115-46-68-140-93-0-117-143-183-89-186-23-137-176-80-79-63-94-124-152-97-1-101-2-120-82-129-57-92-55-52-49-102-148-9-62-144-14-3-178-106-185-165-40-90-81-196-179-145-78-31-56-113-175-171-16-25-44-75-86-26-100-121-53-180-154-135-70-127-123-162-133-151-51-118-59-65-116-43-42-184-112-4-10-177"
86,71968,100,23539,95507,6,"79-63-180-135-70-127-123-162-151-51-118-59-65-116-43-184-112-4-190-10-177-54-48-160-34-146-22-18-108-69-159-181-42-5-115-41-193-139-68-46-0-117-143-183-89-186-23-137-176-80-94-124-152-97-1-101-2-120-82-129-57-92-55-52-49-102-148-9-62-144-14-3-178-106-185-165-40-90-81-196-179-145-78-31-56-113-175-171-16-25-44-75-86-26-100-121-53-158-154-133"
87,72129,100,23879,96008,5,"22-146-159-193-41-139-115-5-42-181-34-160-48-54-177-10-112-4-84-184-43-116-65-149-123-127-162-151-133-135-70-154-180-53-121-100-26-86-75-44-25-16-171-175-113-56-31-78-145-179-196-81-90-40-165-185-106-178-3-14-144-62-9-148-102-49-52-55-92-57-129-82-120-2-101-1-97-152-124-94-63-79-80-176-137-51-59-118-46-68-0-89-183-143-117-93-140-108-69-18"
88,72142,100,23713,95855,5,"79-63-180-135-70-154-158-53-121-100-26-86-75-44-25-16-171-175-113-56-31-78-145-179-196-81-90-40-165-185-106-178-3-14-144-62-9-148-102-49-52-55-92-57-129-82-120-2-101-1-97-152-124-94-80-176-137-23-186-89-183-143-117-0-46-68-139-193-41-115-5-42-181-159-69-108-18-22-146-34-160-48-54-177-10-190-4-112-184-43-116-65-59-118-51-151-162-123-127-133"
89,72458,100,23777,96235,4,"149-131-123-162-133-151-59-118-51-79-63-180-135-70-154-158-53-121-100-26-86-75-44-25-16-171-175-113-56-31-78-145-179-196-81-90-40-165-185-106-178-3-14-144-62-9-148-102-49-52-55-92-57-129-82-120-2-101-1-97-152-124-94-80-176-137-23-186-89-183-143-117-0-46-68-139-193-41-115-116-65-43-42-181-159-69-108-18-22-146-34-160-48-54-177-184-35-84-4-112"
90,72159,100,23446,95605,6,"88-171-175-113-56-31-78-145-179-196-81-90-165-40-185-55-52-106-178-49-14-144-102-62-9-148-15-114-186-23-89-183-143-117-0-137-176-80-151-162-127-123-149-65-116-43-184-84-4-112-10-177-54-48-160-34-146-22-18-108-69-159-181-42-5-41-193-139-68-46-115-59-118-51-133-79-63-94-180-135-70-154-53-100-26-86-75-101-1-97-152-2-129-57-92-82-120-44-25-16"
91,71420,100,22875,94295,4,"35-43-116-65-59-118-51-151-133-162-123-127-70-135-154-180-53-121-100-26-86-75-44-25-16-171-175-113-56-31-78-145-179-196-81-90-40-165-185-106-178-3-14-144-62-9-148-102-49-52-55-92-57-129-82-120-2-101-1-97-152-124-94-63-79-80-176-137-23-186-89-183-143-117-0-93-140-68-46-115-139-193-41-5-42-181-159-69-108-18-22-146-34-160-48-54-177-10-190-184"
92,71057,100,23436,94493,4,"179-196-81-90-165-40-185-55-52-106-178-49-14-144-102-62-9-148-15-114-186-23-89-183-143-117-0-137-176-80-151-162-127-123-149-65-116-43-184-35-84-112-4-190-10-177-54-48-160-34-146-22-18-108-69-159-181-42-5-41-193-139-68-46-115-59-118-51-133-79-63-94-180-135-70-154-53-100-26-86-75-101-1-97-152-2-120-44-25-16-171-175-113-56-31-78-145-92-129-57"
93,72017,100,23461,95478,4,"29-127-123-149-65-43-116-59-118-51-151-133-162-135-70-154-180-53-121-100-26-86-75-44-25-16-171-175-113-56-31-78-145-179-196-81-90-40-165-185-106-178-3-14-144-62-9-148-102-49-52-55-92-57-129-120-2-101-1-97-152-124-94-63-79-80-176-137-23-89-183-143-117-0-93-140-68-46-115-139-193-41-42-181-159-69-108-18-22-146-34-160-48-54-177-184-35-84-4-112"
94,71950,100,23251,95201,5,"158-53-121-100-26-86-75-44-25-16-171-175-113-56-31-78-145-179-196-81-90-40-165-185-106-178-3-14-144-62-9-148-102-49-52-55-92-57-129-82-120-2-101-1-97-152-124-94-63-79-133-162-151-51-80-176-137-23-186-89-183-143-117-0-46-68-139-193-41-5-42-181-159-69-108-18-22-146-34-160-48-54-177-10-190-84-184-43-115-118-59-116-65-149-123-127-70-135-154-180"
95,70888,100,22890,93778,5,"34-181-146-22-18-108-69-159-193-41-139-115-46-68-140-93-0-117-143-183-89-186-23-137-176-80-79-63-94-124-152-97-1-101-2-120-82-129-57-92-55-52-49-102-148-9-62-144-14-3-178-106-185-165-40-90-81-196-179-145-78-31-56-113-175-171-16-25-44-75-86-26-100-121-53-180-154-135-70-127-123-162-133-151-51-118-59-65-116-43-42-184-84-4-112-10-177-54-48-160"
96,70685,100,22585,93270,5,"51-151-133-162-123-127-70-135-154-180-53-121-100-26-86-75-44-25-16-171-175-113-56-31-78-145-179-196-81-90-40-165-185-106-178-3-14-144-62-9-148-102-49-52-55-92-57-129-82-120-2-101-1-97-152-124-94-63-79-80-176-137-23-186-89-183-143-117-0-46-68-139-115-41-193-159-69-108-18-22-146-181-34-160-48-54-177-10-190-4-112-84-35-184-42-43-116-65-59-118"
97,71790,100,23242,95032,4,"106-178-49-14-144-102-62-9-148-15-114-186-23-89-183-143-117-0-137-176-80-151-162-127-123-149-65-116-43-184-190-10-177-54-48-160-34-146-22-18-108-69-159-181-42-5-41-193-139-68-46-115-59-118-51-133-79-63-180-135-70-154-158-53-121-94-124-152-97-1-101-26-100-86-75-2-129-57-92-82-120-44-25-16-171-175-113-56-31-78-145-179-196-81-90-40-165-185-55-52"
98,71546,100,23250,94796,5,"114-89-183-143-117-0-46-68-139-193-41-115-5-42-181-159-69-108-18-22-146-34-160-48-54-177-10-112-4-84-184-43-116-65-59-118-51-151-133-162-123-127-70-135-154-180-53-121-100-26-86-75-44-25-16-171-175-113-56-31-78-145-179-196-81-90-40-165-185-106-178-3-14-144-62-9-148-102-49-52-55-92-57-129-82-120-2-101-1-97-152-124-94-63-79-80-176-137-23-186"
99,72476,100,23498,95974,5,"199-18-69-108-140-93-117-143-183-89-0-68-46-118-59-51-137-176-80-79-63-94-124-152-97-1-101-2-120-82-129-57-92-55-52-49-102-148-9-62-144-14-3-178-106-185-165-40-90-81-196-179-145-78-31-56-113-175-171-16-25-44-75-86-26-100-121-53-180-154-70-135-133-151-162-127-123-149-65-116-43-184-84-190-10-177-54-48-160-34-181-42-5-115-139-41-193-159-146-22"
100,72306,100,23593,95899,5,"88-171-175-113-56-31-78-145-179-196-81-90-40-165-185-55-52-106-178-49-14-144-102-62-9-148-15-114-186-23-89-183-143-117-0-137-176-80-151-162-127-123-149-65-116-43-184-84-4-112-10-177-54-48-160-34-146-22-18-108-69-159-181-42-5-41-193-139-68-46-115-59-118-51-133-79-63-94-180-135-70-154-53-100-26-86-75-101-1-97-152-2-129-57-92-82-120-44-25-16"
101,71960,100,23210,95170,4,"3-49-14-144-102-62-9-148-15-114-186-23-89-183-143-117-0-137-176-80-151-162-127-123-149-65-116-43-184-10-177-54-48-160-34-146-22-18-108-69-159-181-42-5-41-193-139-68-46-115-59-118-51-133-79-63-180-135-70-154-158-53-121-94-124-152-97-1-101-26-100-86-75-2-129-57-92-82-120-44-25-16-171-175-113-56-31-78-145-179-196-81-90-40-165-185-55-52-106-178"
102,71093,100,22888,93981,5,"63-79-80-176-137-23-186-89-183-143-117-0-46-68-139-193-41-115-5-42-181-159-69-108-18-22-146-34-160-48-54-177-10-190-4-112-84-184-43-116-65-59-118-51-151-133-162-123-127-70-135-154-180-53-121-100-26-86-75-44-25-16-171-175-113-56-31-78-145-179-196-81-90-40-165-185-106-178-3-14-144-62-9-148-102-49-52-55-92-57-129-82-120-2-101-1-97-152-124-94"
103,71667,100,23197,94864,4,"9-62-102-49-178-106-52-55-57-92-129-2-120-44-25-16-171-175-113-56-31-78-145-179-196-81-90-185-40-165-138-14-144-15-114-186-23-89-183-143-117-0-137-176-80-151-162-127-123-149-65-116-43-184-190-10-177-54-48-160-34-146-22-18-108-69-159-181-42-5-41-193-139-68-46-115-59-118-51-133-79-63-180-135-70-154-158-53-121-100-26-86-75-101-1-97-152-94-124-148"
104,71609,100,22985,94594,5,"170-143-183-89-186-23-137-176-80-79-63-94-124-152-97-1-101-2-120-82-129-57-92-55-52-49-102-148-9-62-144-14-3-178-106-185-165-40-90-81-196-179-145-78-31-56-113-175-171-16-25-44-75-86-26-100-121-53-180-154-135-70-127-123-162-133-151-51-118-59-65-116-43-184-84-4-112-10-177-54-48-160-34-146-22-18-108-69-159-181-42-5-115-41-193-139-68-46-0-117"
105,71000,100,22908,93908,5,"30-54-48-160-34-181-146-22-18-108-69-159-193-41-139-115-46-68-140-93-0-117-143-183-89-186-23-137-176-80-79-63-94-124-152-97-1-101-2-120-82-129-57-92-55-52-49-102-148-9-62-144-14-3-178-106-185-165-40-90-81-196-179-145-78-31-56-113-175-171-16-25-44-75-86-26-100-121-53-180-154-135-70-127-123-162-133-151-51-118-59-65-116-43-42-184-112-4-10-177"
106,70840,100,22635,93475,5,"183-143-117-0-46-68-139-115-41-193-5-42-181-159-69-108-18-22-146-34-160-48-54-177-10-190-4-112-84-184-43-116-65-59-118-51-151-133-162-123-127-70-135-154-180-53-121-100-26-86-75-44-25-16-171-175-113-56-31-78-145-179-196-81-90-40-165-185-106-178-3-14-144-62-9-148-102-49-52-55-57-92-129-82-120-2-101-1-97-152-124-94-63-79-80-176-137-23-186-89"
107,71904,100,23654,95558,5,"146-159-193-41-139-115-5-42-181-34-160-48-54-177-10-4-112-84-184-43-116-65-149-123-127-162-151-133-135-70-154-180-53-121-100-26-86-75-44-25-16-171-175-113-56-31-78-145-179-196-81-90-165-40-185-106-178-3-14-144-62-9-148-102-49-52-55-92-57-129-82-120-2-101-1-97-152-124-94-63-79-80-176-137-51-59-118-46-68-0-89-183-143-117-93-140-108-69-18-22"
108,71384,100,22760,94144,7,"170-143-183-89-186-23-137-176-80-79-63-94-124-152-97-1-101-2-120-82-129-57-92-55-52-49-102-148-9-62-144-14-3-178-106-185-40-165-90-81-196-179-145-78-31-56-113-175-171-16-25-44-75-86-26-100-121-53-180-154-135-70-127-123-162-133-151-51-118-59-65-116-43-184-84-112-4-10-177-54-48-160-34-146-22-18-108-69-159-181-42-5-115-41-193-139-68-46-0-117"
109,71041,100,22836,93877,5,"89-183-143-117-0-46-68-139-115-41-193-5-42-181-159-69-108-18-22-146-34-160-48-54-177-10-190-4-112-84-184-43-116-65-59-118-51-151-133-162-123-127-70-135-154-180-53-121-100-26-86-75-44-25-16-171-175-113-56-31-78-145-179-196-81-90-40-165-185-106-178-3-14-144-62-9-148-102-49-52-55-92-57-129-82-120-2-101-1-97-152-124-94-63-79-80-176-137-23-186"
110,71388,100,23183,94571,5,"80-176-79-63-94-124-152-97-1-101-2-120-82-129-57-92-55-52-49-102-148-9-62-144-14-3-178-106-185-165-40-90-81-196-179-145-78-31-56-113-175-171-16-25-44-75-86-26-100-121-53-180-154-135-70-127-123-162-133-151-51-118-59-65-116-43-184-84-112-4-190-10-177-54-48-160-34-146-22-18-108-69-159-181-42-5-115-41-193-139-68-46-0-117-143-183-89-186-23-137"
111,71652,100,23529,95181,5,"123-149-65-116-59-118-115-43-184-112-4-190-10-177-54-48-160-34-146-22-18-108-69-159-181-42-5-41-193-139-68-46-0-117-143-183-89-186-23-137-176-80-51-151-162-133-79-63-94-124-152-97-1-101-2-120-82-129-57-92-55-52-49-102-148-9-62-144-14-3-178-106-185-165-40-90-81-196-179-145-78-31-56-113-175-171-16-25-44-75-86-26-100-121-53-180-154-135-70-127"
112,71960,100,23210,95170,5,"3-49-14-144-102-62-9-148-15-114-186-23-89-183-143-117-0-137-176-80-151-162-127-123-149-65-116-43-184-10-177-54-48-160-34-146-22-18-108-69-159-181-42-5-41-193-139-68-46-115-59-118-51-133-79-63-180-135-70-154-158-53-121-94-124-152-97-1-101-26-100-86-75-2-129-57-92-82-120-44-25-16-171-175-113-56-31-78-145-179-196-81-90-40-165-185-55-52-106-178"
113,71725,100,23296,95021,7,"79-63-180-154-158-53-121-100-26-86-75-44-25-16-171-175-113-56-31-78-145-179-196-81-90-40-165-185-106-178-3-14-144-62-9-148-102-49-52-55-92-57-129-82-120-2-101-1-97-152-124-94-80-176-137-23-186-89-183-143-117-0-46-68-139-115-41-193-5-42-181-159-69-108-18-22-146-34-160-48-54-177-10-4-112-84-184-43-116-65-59-118-51-151-162-123-127-70-135-133"
114,71667,100,23197,94864,4,"144-15-114-186-23-89-183-143-117-0-137-176-80-151-162-127-123-149-65-116-43-184-190-10-177-54-48-160-34-146-22-18-108-69-159-181-42-5-41-193-139-68-46-115-59-118-51-133-79-63-180-135-70-154-158-53-121-100-26-86-75-101-1-97-152-94-124-148-9-62-102-49-178-106-52-55-57-92-129-2-120-44-25-16-171-175-113-56-31-78-145-179-196-81-90-185-40-165-138-14"
115,72192,100,23752,95944,5,"92-179-145-78-31-56-113-175-171-16-25-44-120-2-75-101-1-152-97-26-100-86-53-154-70-135-180-94-63-79-133-51-118-59-115-46-68-139-193-41-5-42-181-159-69-108-18-22-146-34-160-48-54-177-184-43-116-65-149-123-127-162-151-80-176-137-0-117-143-183-89-23-186-114-15-148-9-62-102-144-14-49-178-106-165-39-95-7-164-58-27-90-81-196-40-185-52-55-57-129"
116,71851,100,23667,95518,6,"7-21-144-15-114-186-23-89-183-143-117-0-137-176-80-151-162-123-149-65-116-43-184-177-54-48-160-34-146-22-18-108-69-159-181-42-5-41-193-139-68-46-115-59-118-51-133-79-63-180-135-70-154-53-121-100-26-86-75-101-1-97-152-94-124-148-9-62-102-49-14-178-106-52-55-57-92-129-2-120-44-25-16-171-175-113-56-31-78-145-179-196-81-185-40-165-90-27-95-164"
117,71610,100,23472,95082,5,"4-112-127-123-149-65-43-116-59-118-51-151-133-162-135-70-154-180-53-121-100-26-86-75-44-25-16-171-175-113-56-31-78-145-179-196-81-90-40-165-185-106-178-3-14-144-62-9-148-102-49-52-55-92-57-129-120-2-101-1-97-152-124-94-63-79-80-176-137-23-89-183-143-117-0-93-140-68-46-115-139-193-41-5-42-181-159-69-108-18-22-146-34-160-48-54-177-184-35-84"
118,71790,100,23242,95032,3,"178-49-14-144-102-62-9-148-15-114-186-23-89-183-143-117-0-137-176-80-151-162-127-123-149-65-116-43-184-190-10-177-54-48-160-34-146-22-18-108-69-159-181-42-5-41-193-139-68-46-115-59-118-51-133-79-63-180-135-70-154-158-53-121-94-124-152-97-1-101-26-100-86-75-2-129-57-92-82-120-44-25-16-171-175-113-56-31-78-145-179-196-81-90-40-165-185-55-52-106"
119,72139,100,23145,95284,4,"37-9-62-102-49-178-106-52-55-57-92-129-2-120-44-25-16-171-175-113-56-31-78-145-179-196-81-90-185-40-165-138-14-144-15-114-186-23-89-183-143-117-0-137-176-80-151-162-127-123-149-65-116-43-184-177-54-48-160-34-146-22-18-108-69-159-181-42-5-41-193-139-68-46-115-59-118-51-133-79-63-180-135-70-154-158-53-121-100-26-86-75-101-1-97-152-94-124-167-148"
120,71587,100,23464,95051,5,"180-53-121-100-26-86-75-44-25-16-171-175-113-56-31-78-145-179-196-81-90-165-40-185-106-178-3-14-144-62-9-148-102-49-52-55-92-57-129-82-120-2-101-1-97-152-124-94-63-79-133-162-151-51-80-176-137-23-186-89-183-143-117-0-46-68-139-193-41-5-42-181-159-69-108-18-22-146-34-160-48-54-177-10-112-4-84-184-43-115-118-59-116-65-149-123-127-70-135-154"
121,71948,100,23343,95291,7,"39-165-40-185-90-81-196-179-145-78-31-56-113-175-171-16-25-44-120-2-129-92-57-55-52-106-178-49-102-62-9-148-124-94-152-97-1-101-75-86-26-100-121-53-158-154-70-135-180-63-79-133-51-118-59-115-46-68-139-193-41-5-42-181-159-69-108-18-22-146-34-160-48-54-177-10-184-43-116-65-149-123-127-162-151-80-176-137-0-117-143-183-89-23-186-114-15-144-14-138"
122,72657,100,23731,96388,4,"198-115-59-118-51-137-176-80-79-63-94-124-152-97-1-101-2-120-82-129-57-92-55-52-49-102-148-9-62-144-14-3-178-106-185-165-40-90-81-196-179-145-78-31-56-113-175-171-16-25-44-75-86-26-100-121-53-180-154-70-135-133-151-162-127-123-149-65-116-43-184-84-190-10-177-54-48-160-34-146-22-18-108-69-159-181-42-5-41-193-139-68-140-93-117-143-183-89-0-46"
123,71656,100,23533,95189,4,"70-135-154-180-53-121-100-26-86-75-44-25-16-171-175-113-56-31-78-145-179-196-81-90-40-165-185-106-178-3-14-144-62-9-148-102-49-52-55-92-57-129-82-120-2-101-1-97-152-124-94-63-79-133-162-151-51-80-176-137-23-186-89-183-143-117-0-46-68-139-193-41-5-42-181-159-69-108-18-22-146-34-160-48-54-177-10-4-112-84-184-43-115-118-59-116-65-149-123-127"
124,72313,100,23873,96186,4,"57-55-52-185-40-196-81-90-27-58-164-7-95-39-165-106-178-49-14-144-102-62-9-148-15-114-186-23-89-183-143-117-0-137-176-80-151-162-127-123-149-65-116-43-184-177-54-48-160-34-146-22-18-108-69-159-181-42-5-41-193-139-68-46-115-59-118-51-133-79-63-94-180-135-70-154-53-86-75-100-26-97-101-1-152-2-120-44-25-16-171-175-113-56-31-78-145-179-92-129"
125,71766,100,23582,95348,7,"95-164-7-21-14-144-15-114-186-23-89-183-143-117-0-137-176-80-151-162-123-149-65-116-43-184-177-54-48-160-34-146-22-18-108-69-159-181-42-5-41-193-139-68-46-115-59-118-51-133-79-63-180-135-70-154-53-121-100-26-86-75-101-1-97-152-94-124-148-9-62-102-49-178-106-52-55-57-92-129-2-120-44-25-16-171-175-113-56-31-78-145-179-196-81-185-40-165-90-27"
126,71093,100,22888,93981,4,"23-186-89-183-143-117-0-46-68-139-193-41-115-5-42-181-159-69-108-18-22-146-34-160-48-54-177-10-190-4-112-84-184-43-116-65-59-118-51-151-133-162-123-127-70-135-154-180-53-121-100-26-86-75-44-25-16-171-175-113-56-31-78-145-179-196-81-90-40-165-185-106-178-3-14-144-62-9-148-102-49-52-55-92-57-129-82-120-2-101-1-97-152-124-94-63-79-80-176-137"
127,71525,100,23387,94912,5,"4-112-127-123-149-65-43-116-59-118-51-151-133-162-135-70-154-180-53-121-100-26-86-75-129-57-92-55-52-49-102-148-9-62-144-14-3-178-106-185-165-40-90-81-196-179-145-78-31-56-113-175-171-16-25-44-120-2-101-1-97-152-124-94-63-79-80-176-137-23-89-183-143-117-0-93-140-68-46-115-139-193-41-5-42-181-159-69-108-18-22-146-34-160-48-54-177-184-35-84"
128,71790,100,23242,95032,4,"178-49-14-144-102-62-9-148-15-114-186-23-89-183-143-117-0-137-176-80-151-162-127-123-149-65-116-43-184-190-10-177-54-48-160-34-146-22-18-108-69-159-181-42-5-41-193-139-68-46-115-59-118-51-133-79-63-180-135-70-154-158-53-121-94-124-152-97-1-101-26-100-86-75-2-129-57-92-82-120-44-25-16-171-175-113-56-31-78-145-179-196-81-90-40-165-185-55-52-106"
129,71420,100,22875,94295,6,"35-43-116-65-59-118-51-151-133-162-123-127-70-135-154-180-53-121-100-26-86-75-44-25-16-171-175-113-56-31-78-145-179-196-81-90-40-165-185-106-178-3-14-144-62-9-148-102-49-52-55-92-57-129-82-120-2-101-1-97-152-124-94-63-79-80-176-137-23-186-89-183-143-117-0-93-140-68-46-115-139-193-41-5-42-181-159-69-108-18-22-146-34-160-48-54-177-10-190-184"
130,70767,100,22567,93334,6,"84-112-4-177-54-48-160-34-181-146-22-18-108-69-159-193-41-139-115-46-68-140-93-0-117-143-183-89-186-23-137-176-80-79-63-94-124-152-97-1-101-2-120-82-129-92-57-55-52-49-102-148-9-62-144-14-3-178-106-185-165-40-90-81-196-179-145-78-31-56-113-175-171-16-25-44-75-86-26-100-121-53-180-154-135-70-127-123-162-133-151-51-118-59-65-116-43-42-184-35"
131,71847,100,23533,95380,6,"195-146-22-18-108-69-159-193-41-139-68-140-93-117-143-183-89-0-46-115-59-118-51-137-176-80-79-63-94-124-152-97-1-101-2-120-44-25-16-171-175-113-56-31-78-145-179-196-81-90-40-165-185-106-178-3-14-144-62-9-148-102-49-52-55-57-92-129-82-75-86-26-100-121-53-180-154-70-135-133-151-162-127-123-149-65-116-43-42-184-112-4-190-10-177-54-48-160-34-181"
132,72385,100,23381,95766,8,"157-196-81-90-27-58-164-7-95-39-165-40-185-55-52-106-178-49-14-144-62-9-148-15-114-186-23-89-183-143-117-0-137-176-80-151-162-123-149-65-116-43-184-177-54-48-160-34-146-22-18-108-69-159-181-42-5-41-193-139-68-46-115-59-118-51-133-79-63-94-180-135-70-154-53-100-26-86-75-101-1-97-152-2-129-57-92-82-120-44-25-16-171-175-113-56-31-78-145-179"
133,72711,100,22978,95689,5,"85-56-113-175-171-16-31-145-78-25-44-120-82-92-57-129-2-152-97-1-101-75-86-26-100-53-154-70-135-180-94-63-79-133-151-162-123-149-65-116-43-184-177-54-48-160-34-146-22-18-108-69-159-181-42-5-41-193-139-68-46-115-59-118-51-80-176-137-0-117-143-183-89-23-186-114-15-148-9-62-144-14-49-178-106-52-55-185-40-165-39-95-7-164-58-27-90-81-196-157"
134,70983,100,22923,93906,5,"2-152-97-1-101-75-86-26-100-53-158-154-70-135-180-94-63-79-80-176-51-151-133-162-127-123-149-59-118-65-116-43-42-184-35-84-112-4-190-10-177-54-48-160-34-181-195-146-22-18-108-69-159-193-41-115-139-68-46-0-117-143-183-89-186-23-137-148-9-62-102-144-14-49-178-106-52-55-185-165-40-90-81-196-179-145-78-31-56-113-175-171-16-25-44-120-82-92-57-129"
135,71667,100,23197,94864,4,"165-40-185-90-81-196-179-145-78-31-56-113-175-171-16-25-44-120-2-129-92-57-55-52-106-178-49-102-62-9-148-124-94-152-97-1-101-75-86-26-100-121-53-158-154-70-135-180-63-79-133-51-118-59-115-46-68-139-193-41-5-42-181-159-69-108-18-22-146-34-160-48-54-177-10-190-184-43-116-65-149-123-127-162-151-80-176-137-0-117-143-183-89-23-186-114-15-144-14-138"
136,72736,100,24432,97168,7,"167-152-2-75-100-26-97-1-101-86-53-154-70-135-180-94-63-79-133-162-127-123-149-65-116-43-184-177-54-48-160-34-146-22-18-108-69-159-181-42-5-41-193-139-68-46-115-59-118-51-151-80-176-137-0-117-143-183-89-23-186-114-15-148-9-62-102-144-14-49-178-106-165-39-95-164-27-90-81-196-40-185-52-55-57-92-179-145-78-31-56-113-175-171-16-25-44-120-82-129"
137,72048,100,23608,95656,6,"129-57-55-52-185-40-196-81-90-27-58-164-7-95-39-165-106-178-49-14-144-102-62-9-148-15-114-186-23-89-183-143-117-0-137-176-51-118-59-115-46-68-139-193-41-5-42-181-159-69-108-18-22-146-34-160-48-54-177-184-43-116-65-149-123-127-162-151-80-133-79-63-94-180-135-70-154-53-100-26-86-75-101-1-97-152-2-120-44-25-16-171-175-113-56-31-78-145-179-92"
138,72418,100,24019,96437,6,"149-123-127-112-4-84-35-184-177-54-48-160-34-146-22-18-108-69-159-181-42-43-65-116-115-41-193-139-68-46-0-117-143-183-89-186-23-137-176-80-94-124-152-97-1-101-2-120-82-129-57-92-55-52-49-102-148-9-62-144-14-3-178-106-185-165-40-90-81-196-179-145-78-31-56-113-175-171-16-25-44-75-86-26-100-121-53-158-154-70-135-180-63-79-51-118-59-151-133-162"
139,71185,100,23110,94295,5,"86-26-100-121-53-158-154-70-135-180-63-79-80-176-51-151-133-162-127-123-149-59-65-116-43-42-184-112-4-190-10-177-54-48-160-34-181-146-22-18-108-69-159-193-41-115-139-68-46-0-117-143-183-89-23-137-186-114-15-9-62-144-14-138-165-40-185-90-81-196-179-145-78-31-56-113-175-171-16-25-44-120-2-129-92-57-55-52-106-178-49-102-148-124-94-152-97-1-101-75"
140,71267,100,23192,94459,4,"124-94-152-97-1-101-75-86-26-100-121-53-158-154-70-135-180-63-79-80-176-51-151-133-162-127-123-149-59-65-116-43-42-184-84-4-112-10-177-54-48-160-34-181-146-22-18-108-69-159-193-41-115-139-68-46-0-117-143-183-89-23-137-186-114-15-9-62-144-14-138-165-40-185-90-81-196-179-145-78-31-56-113-175-171-16-25-44-120-2-129-92-57-55-52-106-178-49-102-148"
141,71546,100,23250,94796,6,"114-89-183-143-117-0-46-68-139-193-41-115-5-42-181-159-69-108-18-22-146-34-160-48-54-177-10-112-4-84-184-43-116-65-59-118-51-151-133-162-123-127-70-135-154-180-53-121-100-26-86-75-44-25-16-171-175-113-56-31-78-145-179-196-81-90-40-165-185-106-178-3-14-144-62-9-148-102-49-52-55-92-57-129-82-120-2-101-1-97-152-124-94-63-79-80-176-137-23-186"
142,72816,100,23890,96706,5,"198-193-41-5-42-181-159-69-108-18-22-146-34-160-48-54-177-10-190-84-184-43-116-65-149-123-127-162-151-133-135-70-154-180-53-121-100-26-86-75-44-25-16-171-175-113-56-31-78-145-179-196-81-90-165-40-185-106-178-3-14-144-62-9-148-102-49-52-55-92-57-129-82-120-2-101-1-97-152-124-94-63-79-80-176-137-51-118-59-115-139-46-0-89-183-143-117-93-140-68"
143,72652,100,23726,96378,6,"198-115-59-118-51-137-176-80-79-63-94-124-152-97-1-101-2-120-44-25-16-171-175-113-56-31-78-145-179-196-81-90-40-165-185-106-178-3-14-144-62-9-148-102-49-52-55-92-57-129-82-75-86-26-100-121-53-180-154-70-135-133-151-162-127-123-149-65-116-43-184-84-190-10-177-54-48-160-34-146-22-18-108-69-159-181-42-5-41-193-139-68-140-93-117-143-183-89-0-46"
144,71652,100,23529,95181,5,"70-135-154-180-53-121-100-26-86-75-44-25-16-171-175-113-56-31-78-145-179-196-81-90-40-165-185-106-178-3-14-144-62-9-148-102-49-52-55-92-57-129-82-120-2-101-1-97-152-124-94-63-79-133-162-151-51-80-176-137-23-186-89-183-143-117-0-46-68-139-193-41-5-42-181-159-69-108-18-22-146-34-160-48-54-177-10-190-4-112-184-43-115-118-59-116-65-149-123-127"
145,71290,100,23512,94802,4,"171-175-113-56-31-78-145-179-196-81-90-40-165-185-55-52-106-178-49-14-144-102-62-9-148-15-114-186-23-89-183-143-117-0-137-176-80-151-162-127-123-149-65-116-43-184-84-112-4-190-10-177-54-48-160-34-146-22-18-108-69-159-181-42-5-41-193-139-68-46-115-59-118-51-133-79-63-94-180-135-70-154-53-100-26-86-75-101-1-97-152-2-129-57-92-82-120-44-25-16"
146,72546,100,23767,96313,5,"124-94-152-97-1-101-2-120-82-129-57-92-179-145-78-31-56-113-175-171-16-25-44-75-86-26-100-121-53-158-154-70-135-180-63-79-80-176-51-133-151-162-127-123-149-59-65-116-43-184-190-10-177-54-48-160-34-146-22-18-108-69-159-181-42-5-115-41-193-139-68-46-0-117-143-183-89-23-137-186-114-15-9-62-144-14-138-165-90-81-196-40-185-55-52-106-178-49-102-148"
147,70680,100,22580,93260,6,"65-59-118-51-151-133-162-123-127-70-135-154-180-53-121-100-26-86-75-82-129-57-92-55-52-49-102-148-9-62-144-14-3-178-106-185-165-40-90-81-196-179-145-78-31-56-113-175-171-16-25-44-120-2-101-1-97-152-124-94-63-79-80-176-137-23-186-89-183-143-117-0-46-68-139-115-41-193-159-69-108-18-22-146-181-34-160-48-54-177-10-190-4-112-84-35-184-42-43-116"
148,72129,100,23879,96008,4,"108-69-18-22-146-159-193-41-139-115-5-42-181-34-160-48-54-177-10-112-4-84-184-43-116-65-149-123-127-162-151-133-135-70-154-180-53-121-100-26-86-75-44-25-16-171-175-113-56-31-78-145-179-196-81-90-40-165-185-106-178-3-14-144-62-9-148-102-49-52-55-92-57-129-82-120-2-101-1-97-152-124-94-63-79-80-176-137-51-59-118-46-68-0-89-183-143-117-93-140"
149,71070,100,23292,94362,6,"196-81-90-40-165-185-55-52-106-178-49-14-144-102-62-9-148-15-114-186-23-89-183-143-117-0-137-176-80-51-118-59-115-46-68-139-193-41-5-42-181-159-69-108-18-22-146-34-160-48-54-177-10-190-4-112-84-184-43-116-65-149-123-127-162-151-133-79-63-94-180-135-70-154-53-100-26-86-75-101-1-97-152-2-129-57-92-82-120-44-25-16-171-175-113-56-31-78-145-179"
150,71667,100,23197,94864,4,"9-62-102-49-178-106-52-55-57-92-129-2-120-44-25-16-171-175-113-56-31-78-145-179-196-81-90-185-40-165-138-14-144-15-114-186-23-89-183-143-117-0-137-176-80-151-162-127-123-149-65-116-43-184-190-10-177-54-48-160-34-146-22-18-108-69-159-181-42-5-41-193-139-68-46-115-59-118-51-133-79-63-180-135-70-154-158-53-121-100-26-86-75-101-1-97-152-94-124-148"
151,71063,100,22563,93626,4,"160-34-146-22-18-108-69-159-181-42-5-41-193-139-115-46-68-140-93-117-0-143-183-89-186-23-137-176-80-79-63-94-124-152-97-1-101-2-120-82-129-57-92-55-52-49-102-148-9-62-144-14-3-178-106-185-165-40-90-81-196-179-145-78-31-56-113-175-171-16-25-44-75-86-26-100-121-53-180-154-135-70-127-123-162-133-151-51-118-59-65-116-43-184-84-190-10-177-54-48"
152,71575,100,22853,94428,4,"189-152-97-1-101-75-86-26-100-121-53-158-154-70-135-180-63-79-80-176-51-151-133-162-127-123-149-59-65-116-43-42-184-84-190-10-177-54-48-160-34-181-146-22-18-108-69-159-193-41-115-139-68-46-0-117-143-183-89-23-137-186-114-15-9-62-144-14-138-165-40-185-90-81-196-179-145-78-31-56-113-175-171-16-25-44-120-2-129-92-57-55-52-106-178-49-102-148-124-94"
153,72419,100,24113,96532,8,"124-94-2-129-82-120-44-25-16-171-175-113-56-31-78-145-179-92-57-55-52-185-40-196-81-90-27-164-95-39-165-106-178-49-14-144-102-62-9-148-15-114-186-23-89-183-143-117-0-137-176-80-151-162-127-123-149-65-116-43-184-177-54-48-160-34-146-22-18-108-69-159-181-42-5-41-193-139-68-46-115-59-118-51-133-79-63-180-135-70-154-53-86-75-100-26-97-101-1-152"
154,71185,100,23110,94295,4,"0-46-68-139-115-41-193-159-69-108-18-22-146-181-34-160-48-54-177-10-190-4-112-184-42-43-116-65-59-149-123-127-162-133-151-51-176-80-79-63-180-135-70-154-158-53-121-100-26-86-75-101-1-97-152-94-124-148-102-49-178-106-52-55-57-92-129-2-120-44-25-16-171-175-113-56-31-78-145-179-196-81-90-185-40-165-138-14-144-62-9-15-114-186-137-23-89-183-143-117"
155,71656,100,23533,95189,5,"154-180-53-121-100-26-86-75-44-25-16-171-175-113-56-31-78-145-179-196-81-90-40-165-185-106-178-3-14-144-62-9-148-102-49-52-55-92-57-129-82-120-2-101-1-97-152-124-94-63-79-133-162-151-51-80-176-137-23-186-89-183-143-117-0-46-68-139-193-41-5-42-181-159-69-108-18-22-146-34-160-48-54-177-10-4-112-84-184-43-115-118-59-116-65-149-123-127-70-135"
156,71464,100,23168,94632,4,"114-89-183-143-117-0-46-68-139-193-41-115-5-42-181-159-69-108-18-22-146-34-160-48-54-177-10-190-4-112-184-43-116-65-59-118-51-151-133-162-123-127-70-135-154-180-53-121-100-26-86-75-44-25-16-171-175-113-56-31-78-145-179-196-81-90-40-165-185-106-178-3-14-144-62-9-148-102-49-52-55-92-57-129-82-120-2-101-1-97-152-124-94-63-79-80-176-137-23-186"
157,71218,100,23245,94463,5,"149-123-127-162-59-118-51-151-133-135-70-154-180-53-121-100-26-86-75-44-25-16-171-175-113-56-31-78-145-179-196-81-90-40-165-185-106-178-3-14-144-62-9-148-102-49-52-55-92-57-129-82-120-2-101-1-97-152-124-94-63-79-80-176-137-23-186-89-183-143-117-0-46-68-139-115-41-193-159-69-108-18-22-146-181-34-160-48-54-177-10-190-4-112-84-184-42-43-116-65"
158,71185,100,23110,94295,4,"1-101-75-86-26-100-121-53-158-154-70-135-180-63-79-80-176-51-151-133-162-127-123-149-59-65-116-43-42-184-112-4-190-10-177-54-48-160-34-181-146-22-18-108-69-159-193-41-115-139-68-46-0-117-143-183-89-23-137-186-114-15-9-62-144-14-138-165-40-185-90-81-196-179-145-78-31-56-113-175-171-16-25-44-120-2-129-92-57-55-52-106-178-49-102-148-124-94-152-97"
159,71835,100,23336,95171,5,"167-124-94-152-97-1-101-75-86-26-100-121-53-158-154-70-135-180-63-79-133-162-127-123-149-65-116-43-184-10-177-54-48-160-34-146-22-18-108-69-159-181-42-5-41-193-139-68-46-115-59-118-51-151-80-176-137-0-117-143-183-89-23-186-114-15-144-14-138-165-40-185-90-81-196-179-145-78-31-56-113-175-171-16-25-44-120-2-129-92-57-55-52-106-178-49-102-62-9-148"
160,70685,100,22585,93270,5,"43-42-184-35-84-112-4-190-10-177-54-48-160-34-181-146-22-18-108-69-159-193-41-115-139-68-46-0-117-143-183-89-186-23-137-176-80-79-63-94-124-152-97-1-101-2-120-82-129-57-92-55-52-49-102-148-9-62-144-14-3-178-106-185-165-40-90-81-196-179-145-78-31-56-113-175-171-16-25-44-75-86-26-100-121-53-180-154-135-70-127-123-162-133-151-51-118-59-65-116"
161,71857,100,22863,94720,7,"37-9-62-102-49-178-106-52-55-57-92-129-2-120-44-25-16-171-175-113-56-31-78-145-179-196-81-90-40-185-165-138-14-144-15-114-186-23-89-183-143-117-0-137-176-80-51-118-59-115-46-68-139-193-41-5-42-181-159-69-108-18-22-146-34-160-48-54-177-184-43-116-65-149-123-127-162-151-133-79-63-180-135-70-154-158-53-121-100-26-86-75-101-1-97-152-94-124-167-148"
162,71475,100,22609,94084,5,"48-177-54-30-34-181-195-146-22-18-108-69-159-193-41-139-115-46-68-140-93-0-117-143-183-89-186-23-137-176-80-79-63-94-124-152-97-1-101-2-120-82-129-57-92-55-52-49-102-148-9-62-144-14-3-178-106-185-165-119-40-90-81-196-179-145-78-31-56-113-175-171-16-25-44-75-86-26-100-121-53-180-154-135-70-127-123-162-133-151-51-118-59-149-65-116-43-42-184-160"
163,72047,100,23797,95844,5,"22-146-159-193-41-139-115-5-42-181-34-160-48-54-177-10-190-4-112-184-43-116-65-149-123-127-162-151-133-135-70-154-180-53-121-100-26-86-75-44-25-16-171-175-113-56-31-78-145-179-196-81-90-40-165-185-106-178-3-14-144-62-9-148-102-49-52-55-92-57-129-82-120-2-101-1-97-152-124-94-63-79-80-176-137-51-59-118-46-68-0-89-183-143-117-93-140-108-69-18"
164,71610,100,23472,95082,5,"4-112-127-123-149-65-43-116-59-118-51-151-133-162-135-70-154-180-53-121-100-26-86-75-44-25-16-171-175-113-56-31-78-145-179-196-81-90-40-165-185-106-178-3-14-144-62-9-148-102-49-52-55-92-57-129-120-2-101-1-97-152-124-94-63-79-80-176-137-23-89-183-143-117-0-93-140-68-46-115-139-193-41-5-42-181-159-69-108-18-22-146-34-160-48-54-177-184-35-84"
165,71302,100,23227,94529,4,"121-53-158-154-70-135-180-63-79-80-176-51-151-133-162-127-123-149-59-65-116-43-42-184-112-4-190-10-177-54-48-160-34-181-146-22-18-108-69-159-193-41-115-139-68-46-0-117-143-183-89-23-137-186-114-15-9-62-144-14-138-165-40-185-90-81-196-179-145-78-31-56-113-175-171-16-25-44-120-2-129-92-57-55-52-106-178-49-102-148-124-94-152-1-101-75-86-97-26-100"
166,71293,100,22793,94086,5,"184-84-190-10-177-54-48-160-34-146-22-18-108-69-159-181-42-5-41-193-139-115-46-68-140-93-0-117-143-183-89-186-23-137-176-80-79-63-94-124-152-97-1-101-2-120-82-129-57-92-55-52-49-102-148-9-62-144-14-3-178-106-185-165-40-90-81-196-179-145-78-31-56-113-175-171-16-25-44-75-86-26-100-121-53-180-154-135-70-127-123-162-133-151-51-118-59-65-116-43"
167,71290,100,23512,94802,4,"196-81-90-40-165-185-55-52-106-178-49-14-144-102-62-9-148-15-114-186-23-89-183-143-117-0-137-176-80-151-162-127-123-149-65-116-43-184-84-112-4-190-10-177-54-48-160-34-146-22-18-108-69-159-181-42-5-41-193-139-68-46-115-59-118-51-133-79-63-94-180-135-70-154-53-100-26-86-75-101-1-97-152-2-129-57-92-82-120-44-25-16-171-175-113-56-31-78-145-179"
168,72147,100,23897,96044,6,"193-139-68-140-93-117-143-183-89-0-46-115-59-118-51-137-176-80-79-63-94-124-152-97-1-101-2-120-82-129-92-57-55-52-49-102-148-9-62-144-14-3-178-106-185-165-40-90-81-196-179-145-78-31-56-113-175-171-16-25-44-75-86-26-100-121-53-180-154-70-135-133-151-162-127-123-149-65-116-43-184-84-4-112-10-177-54-48-160-34-146-22-18-108-69-159-181-42-5-41"
169,71667,100,23197,94864,4,"62-102-49-178-106-52-55-57-92-129-2-120-44-25-16-171-175-113-56-31-78-145-179-196-81-90-185-40-165-138-14-144-15-114-186-23-89-183-143-117-0-137-176-80-151-162-127-123-149-65-116-43-184-190-10-177-54-48-160-34-146-22-18-108-69-159-181-42-5-41-193-139-68-46-115-59-118-51-133-79-63-180-135-70-154-158-53-121-100-26-86-75-101-1-97-152-94-124-148-9"
170,70888,100,22890,93778,4,"54-48-160-34-181-146-22-18-108-69-159-193-41-139-115-46-68-140-93-0-117-143-183-89-186-23-137-176-80-79-63-94-124-152-97-1-101-2-120-82-129-57-92-55-52-49-102-148-9-62-144-14-3-178-106-185-165-40-90-81-196-179-145-78-31-56-113-175-171-16-25-44-75-86-26-100-121-53-180-154-135-70-127-123-162-133-151-51-118-59-65-116-43-42-184-84-4-112-10-177"
171,71290,100,23512,94802,4,"145-78-31-56-113-175-171-16-25-44-120-82-92-57-129-2-152-97-1-101-75-86-26-100-53-154-70-135-180-94-63-79-133-51-118-59-115-46-68-139-193-41-5-42-181-159-69-108-18-22-146-34-160-48-54-177-10-190-4-112-84-184-43-116-65-149-123-127-162-151-80-176-137-0-117-143-183-89-23-186-114-15-148-9-62-102-144-14-49-178-106-52-55-185-165-40-90-81-196-179"
172,71293,100,22793,94086,5,"84-190-10-177-54-48-160-34-146-22-18-108-69-159-181-42-5-41-193-139-115-46-68-140-93-0-117-143-183-89-186-23-137-176-80-79-63-94-124-152-97-1-101-2-120-82-129-57-92-55-52-49-102-148-9-62-144-14-3-178-106-185-165-40-90-81-196-179-145-78-31-56-113-175-171-16-25-44-75-86-26-100-121-53-180-154-135-70-127-123-162-133-151-51-118-59-65-116-43-184"
173,72275,100,23962,96237,5,"21-144-15-114-186-23-89-183-143-117-0-137-176-80-151-162-127-123-149-65-116-43-184-10-177-54-48-160-34-146-22-18-108-69-159-181-42-5-41-193-139-68-46-115-59-118-51-133-79-63-180-135-70-154-158-53-121-100-26-86-75-101-1-97-152-94-124-148-9-62-102-49-178-106-52-55-57-92-129-2-120-44-25-16-171-175-113-56-31-78-145-179-196-81-90-185-40-165-138-14"
174,72047,100,23797,95844,6,"69-18-22-146-159-193-41-139-115-5-42-181-34-160-48-54-177-10-190-4-112-184-43-116-65-149-123-127-162-151-133-135-70-154-180-53-121-100-26-86-75-44-25-16-171-175-113-56-31-78-145-179-196-81-90-40-165-185-106-178-3-14-144-62-9-148-102-49-52-55-92-57-129-82-120-2-101-1-97-152-124-94-63-79-80-176-137-51-59-118-46-68-0-89-183-143-117-93-140-108"
175,71185,100,23110,94295,4,"0-46-68-139-115-41-193-159-69-108-18-22-146-181-34-160-48-54-177-10-190-4-112-184-42-43-116-65-59-149-123-127-162-133-151-51-176-80-79-63-180-135-70-154-158-53-121-100-26-86-75-101-1-97-152-94-124-148-102-49-178-106-52-55-57-92-129-2-120-44-25-16-171-175-113-56-31-78-145-179-196-81-90-185-40-165-138-14-144-62-9-15-114-186-137-23-89-183-143-117"
176,72275,100,23962,96237,7,"21-144-15-114-186-23-89-183-143-117-0-137-176-80-151-162-127-123-149-65-116-43-184-10-177-54-48-160-34-146-22-18-108-69-159-181-42-5-41-193-139-68-46-115-59-118-51-133-79-63-180-135-70-154-158-53-121-100-26-86-75-101-1-97-152-94-124-148-9-62-102-49-178-106-52-55-57-92-129-2-120-44-25-16-171-175-113-56-31-78-145-179-196-81-90-185-40-165-138-14"
177,72385,100,23381,95766,5,"179-145-78-31-56-113-175-171-16-25-44-120-82-92-57-129-2-152-97-1-101-75-86-26-100-53-154-70-135-180-94-63-79-133-51-118-59-115-46-68-139-193-41-5-42-181-159-69-108-18-22-146-34-160-48-54-177-184-43-116-65-149-123-162-151-80-176-137-0-117-143-183-89-23-186-114-15-148-9-62-144-14-49-178-106-52-55-185-40-165-39-95-7-164-58-27-90-81-196-157"
178,72057,100,23743,95800,5,"195-146-22-18-108-69-159-193-41-139-68-140-93-117-143-183-89-0-46-115-59-118-51-137-176-80-79-63-94-124-152-97-1-101-2-120-82-129-57-92-55-52-49-102-148-9-62-144-14-3-178-106-185-165-40-90-81-196-179-145-78-31-56-113-175-171-16-25-44-75-86-26-100-121-53-180-154-70-135-133-151-162-127-123-149-65-116-43-42-184-84-112-4-10-177-54-48-160-34-181"
179,71497,100,23719,95216,4,"31-56-113-175-171-16-78-25-44-120-82-92-57-129-2-152-97-1-101-75-86-26-100-53-154-70-135-180-94-63-79-133-51-118-59-115-46-68-139-193-41-5-42-181-159-69-108-18-22-146-34-160-48-54-177-10-190-4-112-84-184-43-116-65-149-123-127-162-151-80-176-137-0-117-143-183-89-23-186-114-15-148-9-62-102-144-14-49-178-106-52-55-185-165-40-90-81-196-179-145"
180,70685,100,22585,93270,5,"118-59-65-116-43-42-184-35-84-112-4-190-10-177-54-48-160-34-181-146-22-18-108-69-159-193-41-115-139-68-46-0-117-143-183-89-186-23-137-176-80-79-63-94-124-152-97-1-101-2-120-82-129-57-92-55-52-49-102-148-9-62-144-14-3-178-106-185-165-40-90-81-196-179-145-78-31-56-113-175-171-16-25-44-75-86-26-100-121-53-180-154-135-70-127-123-162-133-151-51"
181,72042,100,23792,95834,5,"146-159-193-41-139-115-5-42-181-34-160-48-54-177-10-190-4-112-184-43-116-65-149-123-127-162-151-133-135-70-154-180-53-121-100-26-86-75-82-129-57-92-55-52-49-102-148-9-62-144-14-3-178-106-185-165-40-90-81-196-179-145-78-31-56-113-175-171-16-25-44-120-2-101-1-97-152-124-94-63-79-80-176-137-51-59-118-46-68-0-89-183-143-117-93-140-108-69-18-22"
182,71447,100,22977,94424,4,"14-144-15-114-186-23-89-183-143-117-0-137-176-80-51-118-59-115-46-68-139-193-41-5-42-181-159-69-108-18-22-146-34-160-48-54-177-10-190-184-43-116-65-149-123-127-162-151-133-79-63-180-135-70-154-158-53-121-100-26-86-75-101-1-97-152-94-124-148-9-62-102-49-178-106-52-55-57-92-129-2-120-44-25-16-171-175-113-56-31-78-145-179-196-81-90-185-40-165-138"
183,71021,100,22613,93634,5,"72-151-133-162-123-127-70-135-154-180-53-121-100-26-86-75-44-25-16-171-175-113-56-31-78-145-179-196-81-90-40-165-185-106-178-3-14-144-62-9-148-102-49-52-55-92-57-129-82-120-2-101-1-97-152-124-94-63-79-80-176-137-23-186-89-183-143-117-0-46-68-139-115-41-193-159-69-108-18-22-146-181-34-160-48-54-177-10-190-4-112-84-184-42-43-116-65-59-118-51"
184,71204,100,23583,94787,3,"179-196-81-90-40-165-185-55-52-106-178-49-14-144-102-62-9-148-15-114-186-23-89-183-143-117-0-137-176-80-151-162-127-123-149-65-116-43-184-35-84-112-4-190-10-177-54-48-160-34-146-22-18-108-69-159-181-42-5-41-193-139-68-46-115-59-118-51-133-79-63-94-180-135-70-154-53-100-26-86-75-101-1-97-152-2-120-44-25-16-171-175-113-56-31-78-145-92-129-57"
185,71769,100,23208,94977,6,"153-183-89-186-23-137-176-80-79-63-94-124-152-97-1-101-2-129-57-92-55-52-49-102-148-9-62-144-14-3-178-106-185-165-40-90-81-196-179-145-78-31-56-113-175-171-16-25-44-120-82-75-86-26-100-121-53-180-154-135-70-127-123-162-133-151-51-118-59-65-116-43-184-84-4-112-10-177-54-48-160-34-146-22-18-108-69-159-181-42-5-115-41-193-139-68-46-143-117-0"
186,70761,100,22788,93549,5,"149-65-116-43-42-184-84-112-4-190-10-177-54-48-160-34-181-146-22-18-108-69-159-193-41-115-139-68-46-0-117-143-183-89-186-23-137-176-80-79-63-94-124-152-97-1-101-2-120-82-129-57-92-55-52-49-102-148-9-62-144-14-3-178-106-185-165-40-90-81-196-179-145-78-31-56-113-175-171-16-25-44-75-86-26-100-121-53-180-154-135-70-127-123-162-133-151-51-118-59"
187,71790,100,23817,95607,5,"118-151-80-79-63-94-124-152-97-1-101-2-120-82-129-57-92-55-52-49-102-148-9-62-144-14-3-178-106-185-165-40-90-81-196-179-145-78-31-56-113-175-171-16-25-44-75-86-26-100-121-53-180-154-70-135-133-162-127-123-149-59-65-116-43-42-184-84-112-4-190-10-177-54-48-160-34-181-146-22-18-108-69-159-193-41-115-139-68-46-0-117-143-183-89-186-23-137-176-51"
188,72017,100,23461,95478,5,"29-127-123-149-65-43-116-59-118-51-151-133-162-135-70-154-180-53-121-100-26-86-75-44-25-16-171-175-113-56-31-78-145-179-196-81-90-40-165-185-106-178-3-14-144-62-9-148-102-49-52-55-92-57-129-120-2-101-1-97-152-124-94-63-79-80-176-137-23-89-183-143-117-0-93-140-68-46-115-139-193-41-42-181-159-69-108-18-22-146-34-160-48-54-177-184-35-84-4-112"
189,72192,100,23752,95944,5,"75-101-1-152-97-26-100-86-53-154-70-135-180-94-63-79-133-51-118-59-115-46-68-139-193-41-5-42-181-159-69-108-18-22-146-34-160-48-54-177-184-43-116-65-149-123-127-162-151-80-176-137-0-117-143-183-89-23-186-114-15-148-9-62-102-144-14-49-178-106-165-39-95-7-164-58-27-90-81-196-40-185-52-55-57-129-92-179-145-78-31-56-113-175-171-16-25-44-120-2"
190,71790,100,23273,95063,3,"185-55-52-106-178-49-14-144-102-62-9-148-15-114-186-23-89-183-143-117-0-137-176-80-151-162-127-123-149-65-116-43-184-84-190-10-177-54-48-160-34-146-22-18-108-69-159-181-42-5-41-193-139-68-46-115-59-118-51-133-79-94-63-180-135-70-154-158-53-121-100-26-86-75-101-1-97-152-2-129-57-92-82-120-44-25-16-171-175-113-56-31-78-145-179-196-81-90-40-165"
191,71618,100,23665,95283,7,"157-145-179-196-81-90-40-165-185-55-52-106-178-49-14-144-102-62-9-148-15-114-186-23-89-183-143-117-0-137-176-80-51-118-59-115-46-68-139-193-41-5-42-181-159-69-108-18-22-146-34-160-48-54-177-10-4-112-84-184-43-116-65-149-123-127-162-151-133-79-63-94-180-135-70-154-53-100-26-86-75-101-1-97-152-2-129-57-92-82-120-44-25-78-16-171-175-113-56-31"
192,71093,100,22888,93981,4,"186-89-183-143-117-0-46-68-139-193-41-115-5-42-181-159-69-108-18-22-146-34-160-48-54-177-10-190-4-112-84-184-43-116-65-59-118-51-151-133-162-123-127-70-135-154-180-53-121-100-26-86-75-44-25-16-171-175-113-56-31-78-145-179-196-81-90-40-165-185-106-178-3-14-144-62-9-148-102-49-52-55-92-57-129-82-120-2-101-1-97-152-124-94-63-79-80-176-137-23"
193,71998,100,23233,95231,4,"189-152-97-1-101-75-86-26-100-121-53-158-154-70-135-180-63-79-133-51-118-59-115-46-68-139-193-41-5-42-181-159-69-108-18-22-146-34-160-48-54-177-10-184-43-116-65-149-123-127-162-151-80-176-137-0-117-143-183-89-23-186-114-15-144-14-138-165-40-185-90-81-196-179-145-78-31-56-113-175-171-16-25-44-120-2-129-92-57-55-52-106-178-49-102-62-9-148-124-94"
194,70968,100,22589,93557,8,"198-115-139-41-193-159-69-108-18-22-146-181-34-160-48-54-177-10-190-4-112-84-184-42-43-116-65-59-118-51-151-133-162-123-127-70-135-154-180-53-121-100-26-86-75-44-25-16-171-175-113-56-31-78-145-179-196-81-90-40-165-185-106-178-3-14-144-62-9-148-102-49-52-55-92-57-129-82-120-2-101-1-97-152-124-94-63-79-80-176-137-23-186-89-183-143-117-0-46-68"
195,71290,100,23512,94802,4,"175-113-56-31-78-145-179-196-81-90-40-165-185-55-52-106-178-49-14-144-102-62-9-148-15-114-186-23-89-183-143-117-0-137-176-80-151-162-127-123-149-65-116-43-184-84-112-4-190-10-177-54-48-160-34-146-22-18-108-69-159-181-42-5-41-193-139-68-46-115-59-118-51-133-79-63-94-180-135-70-154-53-100-26-86-75-101-1-97-152-2-129-57-92-82-120-44-25-16-171"
196,70685,100,22585,93270,4,"43-42-184-35-84-112-4-190-10-177-54-48-160-34-181-146-22-18-108-69-159-193-41-115-139-68-46-0-117-143-183-89-186-23-137-176-80-79-63-94-124-152-97-1-101-2-120-82-129-57-92-55-52-49-102-148-9-62-144-14-3-178-106-185-165-40-90-81-196-179-145-78-31-56-113-175-171-16-25-44-75-86-26-100-121-53-180-154-135-70-127-123-162-133-151-51-118-59-65-116"
197,71277,100,23499,94776,4,"31-56-113-175-171-16-78-25-44-120-82-92-57-129-2-152-97-1-101-75-86-26-100-53-154-70-135-180-94-63-79-133-151-162-127-123-149-65-116-43-184-84-112-4-190-10-177-54-48-160-34-146-22-18-108-69-159-181-42-5-41-193-139-68-46-115-59-118-51-80-176-137-0-117-143-183-89-23-186-114-15-148-9-62-102-144-14-49-178-106-52-55-185-165-40-90-81-196-179-145"
198,71290,100,23512,94802,4,"25-44-120-82-92-57-129-2-152-97-1-101-75-86-26-100-53-154-70-135-180-94-63-79-133-51-118-59-115-46-68-139-193-41-5-42-181-159-69-108-18-22-146-34-160-48-54-177-10-190-4-112-84-184-43-116-65-149-123-127-162-151-80-176-137-0-117-143-183-89-23-186-114-15-148-9-62-102-144-14-49-178-106-52-55-185-165-40-90-81-196-179-145-78-31-56-113-175-171-16"
199,71093,100,22888,93981,4,"117-143-183-89-186-23-137-176-80-79-63-94-124-152-97-1-101-2-120-82-129-57-92-55-52-49-102-148-9-62-144-14-3-178-106-185-165-40-90-81-196-179-145-78-31-56-113-175-171-16-25-44-75-86-26-100-121-53-180-154-135-70-127-123-162-133-151-51-118-59-65-116-43-184-84-112-4-190-10-177-54-48-160-34-146-22-18-108-69-159-181-42-5-115-41-193-139-68-46-0"
200,71290,100,23512,94802,4,"120-82-92-57-129-2-152-97-1-101-75-86-26-100-53-154-70-135-180-94-63-79-133-51-118-59-115-46-68-139-193-41-5-42-181-159-69-108-18-22-146-34-160-48-54-177-10-190-4-112-84-184-43-116-65-149-123-127-162-151-80-176-137-0-117-143-183-89-23-186-114-15-148-9-62-102-144-14-49-178-106-52-55-185-165-40-90-81-196-179-145-78-31-56-113-175-171-16-25-44"
