SolutionID,TotalCost,NumNodes,TotalDistance,ObjectiveFunction,TotalRunningTime,Cycle
1,50447,100,22583,73030,24,"11-138-33-160-144-56-111-37-35-109-0-29-168-145-3-155-152-170-34-55-18-62-124-143-106-86-183-140-149-28-20-148-47-94-179-185-166-194-76-75-137-114-113-176-180-103-163-89-127-165-187-153-77-141-91-79-61-36-21-87-82-68-8-104-157-177-5-142-78-175-80-190-193-31-54-117-198-156-1-135-63-40-107-100-122-133-147-6-188-169-134-51-191-90-131-121-112-25-182-139"
2,47989,100,22134,70123,23,"70-188-169-132-13-195-168-29-109-35-0-12-160-144-111-81-77-82-8-104-33-49-11-139-134-147-10-133-72-107-40-100-63-135-122-90-191-51-118-74-138-182-25-121-131-1-198-117-54-73-31-193-190-80-45-142-175-78-5-177-21-61-36-91-141-187-153-163-89-127-103-113-176-194-166-106-124-86-185-95-130-99-179-94-47-148-20-28-149-140-183-62-18-55-34-152-184-155-15-3"
3,46857,100,20822,67679,26,"82-21-61-36-177-5-45-142-78-175-162-80-190-136-73-54-31-193-117-198-156-1-16-27-38-131-121-125-90-122-135-102-63-40-107-133-10-178-147-51-118-74-134-6-188-169-3-145-168-139-11-138-33-29-0-109-35-143-106-124-62-18-55-34-170-155-184-152-183-140-4-149-28-20-60-148-47-94-66-179-185-95-86-166-194-176-113-114-137-127-89-103-163-187-153-77-111-144-104-8"
4,49791,100,23018,72809,22,"70-145-168-195-13-132-169-188-6-147-10-133-72-17-107-40-100-63-122-32-135-38-27-16-1-131-121-112-198-117-193-31-54-73-136-190-80-175-5-36-61-91-177-25-118-51-90-191-134-43-139-11-138-33-160-29-109-35-0-144-104-8-21-82-111-14-81-77-141-187-153-163-89-165-127-114-103-26-113-176-194-166-106-143-124-62-18-55-95-86-185-47-148-60-20-140-183-152-155-3"
5,50472,100,21979,72451,21,"132-169-188-6-134-74-118-51-121-131-90-191-147-10-133-122-100-107-40-63-102-135-38-27-16-1-198-117-31-190-80-175-36-61-91-141-77-97-146-187-163-113-176-194-166-52-172-179-66-94-47-60-20-28-149-140-183-199-148-99-130-95-185-86-55-18-62-124-106-143-153-81-111-104-8-82-21-177-25-138-139-11-33-160-144-39-12-35-109-0-29-145-15-3-70-161-13-195-168-126"
6,46483,100,21108,67591,24,"55-34-152-183-140-4-149-28-20-148-47-94-179-185-86-166-194-176-113-103-127-89-163-187-153-81-77-141-61-36-177-5-142-78-175-80-190-193-31-54-117-198-1-131-135-16-27-38-102-63-100-40-107-72-122-133-10-178-90-191-51-121-25-182-138-11-139-43-134-147-6-188-169-132-13-195-168-145-15-70-3-155-189-109-35-0-29-160-33-104-8-21-82-111-41-143-106-124-62-18"
7,46560,100,21198,67758,22,"29-109-35-0-160-33-11-138-8-21-82-111-143-106-124-62-18-55-34-183-140-28-20-60-148-47-94-66-179-185-99-130-95-86-166-194-176-180-113-114-127-89-103-163-153-81-77-141-61-36-177-25-5-78-175-142-45-80-190-193-31-73-54-117-198-156-1-16-27-38-131-112-121-51-125-191-90-122-135-63-100-40-107-133-10-147-134-139-6-188-169-132-70-3-15-145-13-126-195-168"
8,49147,100,21285,70432,23,"132-169-188-6-147-191-90-122-135-63-38-27-1-156-198-117-54-31-193-190-80-136-73-19-112-121-51-98-118-134-139-11-160-33-138-25-177-5-175-36-61-79-91-21-82-141-97-77-81-14-111-8-104-144-29-0-109-35-143-119-153-163-165-127-89-103-113-180-176-194-166-172-179-99-66-94-47-148-20-140-183-95-185-86-181-106-124-62-18-55-34-170-152-155-3-70-145-168-195-13"
9,49414,100,22937,72351,25,"18-62-143-159-106-124-128-86-176-113-103-89-127-114-194-166-185-179-94-47-148-183-140-152-184-155-15-3-70-132-169-188-6-147-191-90-122-133-10-107-40-63-135-38-27-1-156-198-117-193-31-54-73-190-80-162-175-78-142-45-5-25-112-121-131-125-51-13-195-168-139-11-49-29-144-160-33-138-104-8-82-21-177-36-61-79-91-141-77-97-187-163-153-81-111-0-109-35-34-55"
10,47384,100,20976,68360,23,"70-3-15-145-13-195-168-43-139-182-11-33-160-144-29-0-109-35-111-68-8-104-138-177-21-82-77-81-143-106-124-62-18-55-183-140-28-20-60-148-47-94-179-185-95-86-166-194-176-180-113-26-103-114-127-89-163-165-187-153-97-141-91-61-36-5-78-175-45-80-190-136-73-164-54-31-193-117-198-156-1-112-121-131-135-63-40-107-133-122-90-191-51-147-85-134-6-188-169-132"
11,49010,100,21040,70050,23,"20-28-140-183-55-18-62-124-106-34-152-155-3-70-145-195-168-169-188-6-147-191-90-125-131-135-32-122-133-10-107-40-63-38-27-16-1-24-156-198-117-193-105-190-80-175-5-136-73-164-31-54-19-112-121-51-98-118-74-182-25-177-21-82-8-104-160-33-138-139-11-49-29-0-109-35-111-77-81-153-187-163-89-127-103-113-176-88-194-166-86-95-130-185-179-66-94-47-148-60"
12,48625,100,23018,71643,18,"117-198-156-1-54-31-73-25-74-118-98-51-121-131-135-63-40-107-122-133-10-178-90-191-147-188-169-70-3-15-145-155-184-152-34-35-109-0-111-29-168-11-138-33-160-144-56-104-8-21-87-82-81-153-143-106-124-62-18-55-183-140-20-60-148-47-94-66-172-179-185-99-130-95-86-166-194-176-113-114-137-127-89-103-163-165-187-97-77-141-91-61-36-177-5-78-175-80-190-193"
13,48120,100,21507,69627,22,"127-103-113-180-176-88-86-95-55-18-62-124-106-143-35-109-0-29-11-138-33-160-144-111-8-104-21-82-77-97-141-91-61-36-177-5-78-175-142-45-80-190-136-73-54-31-193-117-198-156-42-1-16-27-38-135-63-40-107-10-133-122-90-191-51-121-25-118-98-74-134-6-188-169-168-145-3-155-152-183-140-28-20-60-148-47-154-94-66-179-185-166-194-114-137-165-187-153-163-89"
14,47445,100,20997,68442,19,"190-80-175-78-5-177-36-61-91-141-77-187-165-127-89-103-163-153-81-111-8-33-160-29-0-109-35-143-106-124-128-86-176-113-114-194-166-185-99-179-66-94-47-148-60-20-28-149-140-183-95-62-18-55-34-170-152-155-3-70-161-15-145-168-195-13-132-169-188-6-147-71-67-120-191-90-125-51-118-139-11-138-182-25-112-121-131-122-135-63-38-1-198-117-193-54-31-164-73-136"
15,48589,100,21919,70508,18,"54-151-173-136-190-80-45-142-175-78-5-177-21-61-36-91-141-77-97-187-153-81-143-62-18-55-34-124-106-176-113-103-89-127-137-114-194-166-86-185-95-130-99-179-66-94-47-148-20-140-183-152-155-145-15-3-70-188-169-195-168-29-0-109-35-111-82-8-104-33-11-138-182-118-51-125-90-191-10-133-107-40-63-102-135-122-131-121-112-1-38-27-16-156-198-117-193-31-164-73"
16,49004,100,20724,69728,18,"169-188-6-134-85-182-138-25-121-51-90-122-135-63-38-1-156-198-117-193-31-54-73-190-80-175-5-177-36-61-79-91-21-82-58-81-77-141-97-146-187-153-163-89-127-114-103-113-176-166-179-94-47-148-20-28-149-4-199-140-183-174-152-155-170-34-55-18-62-83-181-95-130-185-86-128-124-106-143-35-109-0-29-12-111-8-104-56-144-160-33-11-139-168-195-145-15-3-70-132"
17,48913,100,21822,70735,21,"36-61-21-58-82-8-104-144-160-33-138-25-177-5-78-175-80-190-73-54-31-193-117-198-156-1-27-38-102-63-40-107-133-122-135-131-112-121-51-125-90-191-147-188-169-168-195-13-145-15-70-3-155-152-183-140-20-60-148-47-154-94-66-172-179-185-86-95-62-18-55-34-35-109-0-29-111-50-14-81-41-143-124-106-180-176-166-194-113-103-89-127-165-163-187-153-77-97-141-91"
18,48352,100,22771,71123,20,"139-138-182-25-121-131-90-191-51-134-43-168-195-126-13-145-15-3-70-132-169-188-147-133-122-135-63-38-27-1-198-117-193-31-54-73-190-80-175-5-177-36-61-21-104-8-82-141-77-81-153-187-163-103-89-165-127-137-114-113-180-176-106-143-124-128-62-18-55-34-174-183-130-95-86-166-194-48-172-179-185-99-94-47-148-20-28-149-4-140-152-155-109-35-0-29-144-160-33-11"
19,48706,100,21122,69828,19,"135-102-63-100-40-107-72-133-10-147-6-188-169-70-3-145-195-168-29-0-109-35-143-106-124-62-18-55-34-152-183-140-4-149-28-59-20-60-154-94-66-47-148-199-9-95-130-99-179-185-86-166-176-113-103-127-89-163-187-153-81-14-50-77-97-141-91-61-36-78-175-142-162-80-190-136-45-5-177-21-82-111-8-104-144-160-33-11-139-134-51-121-73-54-31-193-117-131-90-122"
20,47130,100,21455,68585,19,"20-148-47-94-179-185-166-194-176-113-114-137-127-165-89-103-163-153-111-35-109-0-29-160-33-144-104-8-82-87-21-141-91-61-36-177-5-78-175-80-190-73-54-31-193-117-198-156-1-38-131-121-25-138-11-139-134-118-98-51-125-122-135-63-40-107-133-90-191-71-147-6-188-169-132-126-168-195-13-145-15-70-3-155-184-152-170-34-55-18-62-124-143-106-86-95-183-140-149-28"
21,50514,100,21954,72468,17,"73-136-190-80-162-45-175-78-5-36-177-25-138-139-134-43-11-33-160-29-0-109-35-18-62-124-106-143-111-8-82-77-153-163-89-127-103-113-176-194-166-86-185-179-22-99-95-183-140-199-148-47-94-60-20-28-149-152-184-155-3-145-195-168-132-169-188-6-147-71-120-74-118-98-51-191-90-125-131-135-122-133-10-72-107-40-100-63-38-1-156-198-117-121-112-19-54-31-193-164"
22,49488,100,23204,72692,19,"33-11-139-168-195-132-169-188-70-3-155-152-149-28-140-183-95-130-185-99-148-20-23-60-47-94-66-179-86-166-194-176-113-114-137-127-89-103-163-153-106-124-62-18-55-34-143-35-109-0-29-144-111-81-77-82-8-87-21-61-36-175-78-5-177-25-158-121-112-54-31-164-73-136-80-190-193-117-198-1-38-131-90-191-178-133-122-135-63-40-107-10-147-71-51-118-182-138-104-160"
23,48432,100,21019,69451,19,"190-80-136-73-164-31-54-121-90-191-71-120-51-118-134-139-11-182-138-33-160-29-0-109-35-111-8-82-21-177-5-142-175-78-36-61-141-77-81-159-143-34-55-18-83-62-128-124-106-153-163-103-113-180-176-194-166-86-185-52-172-179-99-130-95-183-9-148-47-94-60-20-59-28-149-140-152-184-155-3-70-15-145-168-195-13-132-169-188-6-147-133-122-135-63-38-27-1-117-193"
24,49736,100,21383,71119,21,"94-179-185-95-86-124-106-143-159-119-180-176-166-194-113-103-114-137-127-89-163-153-81-77-82-8-104-33-160-0-35-109-29-11-138-182-139-134-118-51-121-25-21-177-5-78-175-80-190-136-173-73-164-31-54-193-117-198-156-42-1-38-135-102-63-100-40-107-17-72-44-133-10-122-90-147-188-169-132-13-195-168-145-15-161-70-3-155-184-152-170-34-55-18-62-183-140-28-20-148"
25,47071,100,20600,67671,21,"177-5-78-175-80-190-73-54-31-193-117-198-1-16-27-38-131-121-51-90-122-135-63-100-40-107-133-10-178-147-6-188-169-168-195-145-15-70-3-155-152-183-140-4-149-101-28-20-148-47-94-179-185-86-95-55-18-62-124-143-159-106-166-194-176-180-113-103-89-127-165-163-187-146-153-81-77-97-141-91-36-61-82-111-35-109-0-12-29-11-139-182-138-33-160-144-104-8-87-21"
26,47998,100,20901,68899,18,"63-40-107-100-135-131-121-118-98-51-125-191-90-122-133-10-147-6-188-65-169-132-13-195-168-145-15-161-70-3-155-189-29-0-109-35-143-106-124-62-18-55-34-170-152-149-28-20-140-183-95-185-86-166-194-176-113-114-127-165-89-103-163-187-153-77-141-36-61-21-82-41-111-8-104-56-144-160-33-138-11-139-182-25-177-5-78-175-142-45-80-190-193-31-54-117-198-156-1-38"
27,48668,100,22246,70914,20,"114-137-127-89-103-163-187-153-77-97-141-91-61-36-5-78-175-80-190-193-31-73-54-117-198-156-42-1-38-63-40-107-122-135-131-121-112-25-177-21-82-8-111-35-109-0-29-160-33-11-139-168-195-13-132-169-134-85-74-118-98-51-191-90-178-133-10-115-147-6-188-70-3-15-145-155-152-55-18-62-143-106-124-95-130-183-140-20-148-47-94-66-179-185-86-166-194-176-113-76"
28,47710,100,21691,69401,17,"117-198-1-121-131-135-102-63-40-107-122-90-191-147-150-6-188-169-132-13-195-168-145-15-70-3-155-184-152-183-140-28-20-60-148-47-94-179-166-86-185-130-95-18-34-55-83-62-124-106-143-129-176-194-113-26-103-114-137-127-89-163-153-97-77-81-111-35-109-0-29-49-11-139-134-51-118-74-182-138-33-160-144-104-8-82-21-141-61-36-177-5-78-175-45-80-190-193-31-54"
29,49338,100,21570,70908,19,"177-36-61-141-187-127-89-103-163-153-81-77-82-21-8-104-138-182-139-11-33-160-29-0-109-35-18-62-124-106-176-113-194-166-172-179-94-47-148-185-86-95-183-140-152-184-155-189-145-15-3-70-188-169-132-13-195-168-43-134-74-118-51-125-90-191-10-133-122-72-107-40-100-63-102-135-38-27-16-1-131-121-112-198-117-193-31-54-73-173-136-190-80-162-175-78-142-45-5-25"
30,49909,100,22900,72809,18,"114-75-137-127-103-89-165-187-77-81-153-163-129-159-143-35-109-0-29-160-144-104-8-21-61-36-177-138-33-11-139-51-90-131-121-112-19-54-73-5-142-78-175-80-190-136-31-193-117-198-156-42-1-38-63-40-107-135-122-133-147-188-169-132-13-126-168-195-145-15-161-70-3-155-152-170-34-55-18-83-62-124-106-128-86-185-95-183-140-4-149-28-20-148-94-179-166-194-176-113"
31,49253,100,21376,70629,20,"60-20-28-140-183-152-184-155-189-145-15-3-70-161-132-13-195-168-169-188-6-147-10-133-72-17-107-40-100-63-135-38-27-1-42-156-198-117-193-31-164-73-54-131-122-90-191-51-121-112-19-173-136-190-80-45-175-78-5-36-61-91-141-97-77-82-8-21-177-25-104-111-144-160-33-138-139-11-29-0-35-109-170-34-55-18-83-62-124-106-176-113-194-166-86-185-179-94-47-148"
32,48258,100,22427,70685,20,"94-66-179-185-95-86-166-194-176-113-103-127-89-163-153-81-77-141-36-61-21-177-78-175-5-25-121-51-125-122-32-135-131-117-54-31-73-136-80-190-193-198-156-42-1-16-27-38-63-40-107-133-10-90-191-147-6-188-169-132-134-74-139-182-138-11-168-195-13-70-3-15-145-35-109-0-29-49-33-160-144-104-8-111-143-106-124-62-18-55-34-183-140-149-28-20-23-60-148-47"
33,47897,100,22781,70678,22,"132-169-188-6-147-51-191-90-131-135-122-133-107-40-63-38-27-1-117-193-80-190-73-164-31-54-112-121-25-177-5-45-142-175-78-36-61-91-21-8-104-144-111-77-141-187-165-137-127-89-103-113-194-166-176-180-163-153-143-106-124-128-86-185-179-94-47-148-20-28-149-4-140-183-130-95-62-18-55-34-170-152-53-184-155-3-70-15-145-109-35-0-29-33-138-182-11-139-168-195"
34,47265,100,21293,68558,22,"77-153-187-163-89-127-137-114-103-113-180-176-88-194-166-179-185-86-106-124-62-83-18-55-34-183-148-47-94-60-20-28-149-140-152-170-184-155-189-109-35-0-29-8-104-33-138-11-168-195-13-145-15-3-70-132-169-188-6-134-118-98-51-121-131-125-90-191-147-178-10-133-122-107-40-63-135-38-27-16-1-156-198-117-193-31-54-73-136-190-80-175-78-5-177-21-61-36-91-141"
35,49239,100,21315,70554,23,"191-51-98-118-134-6-188-169-132-70-3-15-145-13-195-168-109-35-0-29-49-11-139-182-138-33-160-144-104-157-21-82-8-111-41-81-119-159-143-106-124-62-18-55-34-152-183-140-28-20-60-148-47-94-179-185-99-130-95-128-86-166-176-113-153-77-97-141-61-36-177-5-78-175-80-190-193-31-54-117-198-156-27-38-1-131-121-90-122-135-63-100-40-107-72-133-10-178-147-71"
36,47350,100,20742,68092,20,"8-21-87-82-111-143-106-124-128-62-18-55-34-152-183-140-28-20-60-148-47-94-66-172-179-22-99-95-185-86-166-194-176-113-103-114-127-89-163-153-81-77-141-91-61-36-175-78-5-177-25-112-121-51-191-90-131-54-31-193-117-198-1-27-38-135-63-40-107-100-122-133-10-178-147-6-188-169-132-13-195-168-145-15-70-3-35-109-0-12-39-29-11-139-138-33-160-144-56-104"
37,48293,100,22550,70843,20,"33-160-144-111-82-8-56-104-138-11-139-134-51-121-112-25-177-61-36-5-78-175-80-190-193-31-164-73-54-117-198-156-42-1-16-27-38-63-100-40-107-133-122-135-90-147-6-188-169-70-3-15-145-155-184-152-170-183-140-28-20-148-47-94-66-179-22-99-95-185-86-166-194-176-113-114-127-89-103-163-153-187-141-77-81-159-143-106-124-128-62-83-18-55-34-35-109-0-29-168"
38,48619,100,20595,69214,21,"78-175-36-61-91-141-97-77-81-153-143-106-163-165-127-137-114-89-103-113-176-88-194-166-86-185-179-66-94-47-148-20-28-149-140-183-99-130-95-128-124-62-18-55-34-170-152-184-155-189-3-70-15-145-132-169-188-195-168-139-51-90-122-135-63-38-1-156-42-30-198-117-193-31-164-73-54-151-19-112-121-25-182-138-11-33-160-29-0-109-35-41-111-144-104-8-82-21-177-5"
39,48110,100,21776,69886,20,"10-90-191-51-182-138-33-11-139-168-195-169-188-70-3-155-184-152-34-55-18-62-124-106-86-185-130-95-183-140-4-149-101-28-20-60-148-47-94-66-179-172-166-194-176-180-113-103-163-89-127-114-137-165-187-153-81-111-35-109-0-29-39-160-144-104-8-82-77-141-61-36-177-25-112-121-131-54-31-73-136-5-78-175-80-190-193-117-198-1-27-38-135-122-96-63-100-40-107-133"
40,48451,100,22140,70591,22,"185-130-95-62-124-106-143-18-55-34-170-155-184-152-183-140-28-20-148-47-94-66-179-166-194-114-127-165-187-141-61-36-5-142-78-175-80-190-73-54-31-193-117-1-16-27-38-102-63-40-107-133-122-32-135-131-121-98-51-125-90-191-71-147-188-169-132-13-70-3-15-145-195-168-11-33-138-25-177-21-8-104-160-29-0-109-35-111-77-81-153-163-89-103-26-113-88-180-176-86"
41,50639,100,22786,73425,20,"153-159-143-106-124-34-55-18-62-128-86-176-88-194-166-179-94-47-185-95-183-152-184-155-109-35-0-12-29-168-195-13-145-3-70-132-169-188-6-147-133-122-100-107-40-63-102-135-38-27-1-156-198-117-193-31-54-73-136-190-80-162-45-142-175-78-36-61-91-21-177-5-173-19-112-121-131-90-51-118-134-139-11-138-33-160-104-8-111-81-77-141-187-165-127-114-113-103-89-163"
42,49796,100,22731,72527,19,"177-5-78-175-45-162-80-190-193-31-164-73-54-117-198-156-1-121-131-135-63-40-107-100-122-133-10-147-67-191-90-125-51-98-118-74-25-104-8-144-160-33-138-11-139-134-6-188-169-132-13-70-3-145-168-29-111-0-109-35-18-55-62-124-106-143-159-81-153-163-176-86-95-183-174-34-170-152-53-140-149-28-20-60-148-47-94-185-166-194-113-103-89-127-165-187-77-141-61-36"
43,48773,100,21316,70089,20,"179-172-66-94-154-47-148-60-20-28-149-140-183-152-3-145-195-168-132-169-188-6-147-10-133-72-107-40-100-63-135-122-90-125-131-1-198-117-193-31-54-73-121-51-98-118-134-139-11-138-33-160-144-56-104-8-87-21-177-5-45-142-175-78-36-61-79-91-141-187-153-81-77-82-111-29-0-109-35-34-18-62-124-143-106-176-113-103-163-89-127-114-194-166-86-95-130-99-22-185"
44,49098,100,21681,70779,20,"47-94-66-179-172-166-194-180-176-86-185-95-34-55-18-83-62-128-124-106-143-81-153-163-113-103-89-127-187-77-141-61-36-177-5-78-175-80-190-73-54-31-193-117-198-156-1-27-38-63-40-107-100-135-122-133-10-178-147-71-191-90-125-131-112-121-51-98-118-74-134-6-188-169-132-195-168-139-11-182-138-33-160-144-56-104-8-82-111-29-0-35-109-152-183-140-28-20-60-148"
45,47611,100,21697,69308,22,"195-13-15-145-109-0-35-111-144-104-8-82-21-177-123-25-121-51-125-90-191-10-133-40-107-122-135-102-63-92-38-27-16-1-198-117-54-31-193-190-80-45-175-78-5-36-61-91-141-77-81-153-163-103-89-165-127-114-113-176-194-166-179-66-94-47-60-20-148-22-99-130-95-185-86-106-124-62-18-55-183-140-152-184-155-3-70-132-169-188-6-147-134-139-11-138-33-160-29-168"
46,47923,100,21029,68952,28,"138-182-139-11-160-29-0-109-35-143-106-153-163-103-113-176-194-166-86-185-179-94-47-148-60-23-20-99-22-130-95-128-124-62-83-18-55-174-183-140-28-149-152-170-34-184-155-145-15-3-70-161-132-13-195-168-169-188-6-147-90-121-131-122-133-107-40-100-63-135-1-198-117-54-31-193-190-80-45-142-175-78-5-177-36-61-91-141-97-77-81-14-111-82-87-21-8-104-144-33"
47,49464,100,22611,72075,23,"124-62-18-34-152-55-86-185-22-99-130-95-183-140-28-20-148-94-179-166-194-176-113-103-114-137-127-89-163-153-77-111-144-160-33-104-8-82-21-141-61-36-177-5-175-80-190-31-54-117-198-1-27-38-63-135-122-100-40-107-72-133-10-178-147-192-6-188-169-132-134-120-191-90-121-51-98-118-74-25-182-138-11-139-168-195-145-15-70-3-155-189-69-29-0-109-35-143-159-106"
48,48045,100,21466,69511,20,"111-82-21-61-36-141-77-81-153-163-103-89-165-127-114-113-194-176-106-124-62-18-55-86-185-179-99-130-95-183-140-148-47-94-60-20-59-28-149-4-152-170-184-155-3-70-188-169-132-13-145-195-168-11-139-51-121-131-135-122-90-10-133-107-40-63-38-1-156-198-117-193-54-31-164-73-173-136-190-80-45-142-175-78-5-177-25-182-138-104-8-56-144-33-160-29-12-0-109-35"
49,49075,100,20815,69890,21,"198-156-1-38-63-100-40-107-72-133-10-178-122-135-131-90-51-147-6-188-169-132-70-3-15-145-13-195-168-139-11-138-104-21-87-82-68-8-56-144-33-160-29-12-0-109-35-37-111-50-143-106-124-62-18-183-140-28-20-148-47-94-179-185-86-166-194-176-113-114-137-127-89-103-163-187-153-77-97-141-61-36-177-25-121-112-19-45-5-78-175-162-80-190-136-73-54-31-193-117"
50,48867,100,19370,68237,17,"190-80-175-78-142-45-5-177-36-61-21-8-104-144-160-33-138-139-11-49-29-0-109-35-111-77-81-153-106-124-62-18-55-34-183-95-130-185-86-176-113-194-166-52-172-179-22-99-66-94-154-47-148-60-20-28-149-140-53-152-170-184-155-3-70-145-168-195-13-132-169-188-6-134-85-74-118-51-125-191-90-122-135-63-38-27-16-156-1-131-121-112-19-54-73-164-31-117-198-193"
51,47452,100,19796,67248,21,"61-21-82-8-104-144-111-77-81-153-163-103-89-127-114-113-176-88-194-166-86-95-130-185-179-94-47-148-60-20-28-149-4-140-183-53-152-170-34-55-18-62-124-106-35-0-29-168-195-126-13-145-15-3-70-132-169-188-11-33-138-25-112-121-51-90-191-147-10-133-107-40-100-122-135-32-63-102-38-27-16-1-198-117-193-31-54-164-73-136-190-80-162-175-78-142-45-5-177-36"
52,46612,100,20905,67517,18,"13-132-169-188-6-134-147-115-178-10-133-107-40-100-63-135-122-90-51-98-118-121-131-38-27-16-1-24-156-198-117-193-31-54-73-136-190-80-45-142-175-78-5-25-177-36-61-91-141-77-81-153-163-89-127-114-103-113-176-194-166-179-66-94-47-148-20-28-140-183-95-185-86-128-124-106-143-62-18-55-34-152-155-29-0-109-35-111-8-104-33-138-11-139-168-195-145-15-3-70"
53,48631,100,20924,69555,19,"63-38-27-16-1-198-117-54-31-193-190-80-175-36-61-141-77-81-111-8-144-33-160-29-12-0-109-35-143-62-18-34-55-128-124-106-153-163-89-103-113-176-88-194-166-86-185-95-130-99-22-179-172-57-66-94-47-148-60-23-20-59-28-149-4-140-183-152-170-184-155-3-70-15-145-13-132-169-188-195-168-139-11-182-138-104-177-25-121-51-71-147-10-133-122-90-191-125-131-135"
54,47200,100,21715,68915,20,"40-100-63-38-27-1-156-198-117-193-54-31-164-73-136-190-80-162-175-78-142-45-5-177-36-61-141-77-81-153-163-103-89-127-137-114-113-176-194-166-106-143-124-128-86-185-179-66-94-47-60-23-148-130-95-183-20-59-28-149-140-55-18-62-34-152-155-109-35-0-29-111-8-104-33-138-182-11-139-168-195-145-3-70-132-169-188-6-147-191-90-125-51-121-131-135-122-133-10-107"
55,48345,100,21525,69870,20,"33-104-21-36-61-79-91-141-77-81-153-187-163-89-127-103-113-176-194-166-86-95-130-185-179-66-94-47-148-60-20-28-149-140-183-55-18-62-128-124-106-143-111-8-144-160-29-0-109-35-34-170-152-155-15-3-70-188-169-132-13-195-168-11-139-134-147-178-10-133-107-40-63-135-122-90-191-51-98-118-116-121-131-1-24-156-42-198-117-151-54-73-164-31-193-190-80-5-177-138"
56,49654,100,20908,70562,21,"106-124-128-86-166-194-176-113-103-127-89-163-187-153-77-111-35-109-0-29-160-33-104-8-21-177-5-45-142-78-175-162-46-80-190-136-73-164-54-31-193-117-198-112-121-131-1-16-27-38-102-135-32-96-63-100-40-107-72-122-133-10-147-6-191-90-125-120-51-138-11-139-168-195-132-169-188-70-3-15-145-155-184-152-183-140-28-20-148-94-179-185-130-95-18-55-34-62-143-159"
57,48322,100,22194,70516,19,"102-38-27-16-156-198-117-193-136-190-80-162-45-142-175-78-5-177-25-138-11-33-160-29-109-35-0-144-104-8-111-37-81-77-82-87-21-61-36-91-141-187-153-163-103-113-176-194-166-86-185-95-130-99-22-179-94-47-148-20-28-149-4-140-183-62-124-106-143-18-55-34-152-155-3-70-15-145-168-195-13-132-169-188-6-134-147-191-90-125-51-121-54-31-1-131-135-122-40-63"
58,49062,100,21269,70331,20,"34-170-152-149-28-140-183-95-130-20-148-47-94-179-185-86-166-194-176-113-103-127-89-163-187-153-81-77-97-141-36-175-5-177-25-182-138-11-139-51-191-90-125-121-112-19-54-73-164-31-193-117-198-156-1-16-27-38-131-135-32-102-63-100-40-107-72-122-133-10-147-6-188-169-70-3-15-145-195-168-29-109-35-0-160-33-144-104-8-21-82-50-111-143-106-124-62-83-18-55"
59,48315,100,22411,70726,19,"135-38-27-1-156-198-117-193-31-54-164-73-136-190-80-175-78-142-45-5-112-121-25-177-36-61-141-77-153-81-41-111-82-8-104-144-0-35-109-29-160-33-138-11-139-168-195-13-145-15-189-143-106-124-86-176-163-89-127-103-113-194-166-172-179-185-95-130-99-22-66-94-47-148-60-20-140-183-62-18-55-34-170-152-155-3-70-132-169-65-188-6-134-147-51-191-90-122-40-63"
60,48217,100,21492,69709,20,"152-3-70-188-169-132-13-145-195-168-11-139-134-118-98-51-121-90-191-10-133-122-135-63-102-38-27-1-24-156-198-117-193-31-54-73-190-80-45-142-175-78-5-36-61-79-91-141-77-82-8-111-144-104-21-177-25-182-138-33-160-29-0-109-35-106-124-34-55-18-62-128-176-113-26-103-127-89-163-153-187-165-137-114-194-166-86-95-130-99-185-179-66-94-47-148-60-20-140-183"
61,48183,100,23158,71341,22,"77-141-61-36-177-5-175-80-190-136-73-54-31-193-117-198-156-42-1-16-27-38-63-40-107-133-10-115-178-122-135-131-121-51-90-147-134-6-188-169-132-161-70-3-15-145-13-195-168-139-11-138-104-21-82-8-33-160-111-81-153-106-143-35-109-0-29-189-155-152-149-28-20-60-94-66-47-148-140-183-130-185-95-55-18-62-124-86-166-194-88-176-113-114-137-127-89-103-163-187"
62,49488,100,22156,71644,18,"112-151-198-117-193-31-54-73-136-190-80-45-175-78-5-25-182-138-33-160-144-104-21-177-36-61-141-77-82-8-111-37-35-0-29-109-34-55-18-83-62-143-106-124-128-110-86-176-163-153-146-187-127-89-103-113-166-185-95-130-99-22-179-66-94-154-47-148-60-20-28-140-183-152-184-155-3-70-145-195-168-169-188-147-71-191-51-125-90-122-133-107-40-63-135-38-27-1-131-121"
63,48612,100,20907,69519,21,"168-169-188-6-134-85-74-118-147-191-90-125-51-121-112-19-131-122-44-133-10-107-40-63-135-38-27-16-1-198-117-193-54-31-164-73-136-105-190-80-162-175-78-142-45-5-177-36-61-141-77-82-8-104-33-138-182-139-11-29-0-109-35-143-106-124-62-34-55-18-128-176-180-163-153-187-127-89-103-113-194-166-86-185-179-94-47-148-20-28-140-183-152-184-155-189-3-70-15-145"
64,47879,100,20970,68849,19,"194-176-113-103-127-89-163-153-81-77-97-141-61-36-177-5-78-175-142-45-80-190-193-31-164-73-54-117-198-156-1-38-63-100-40-107-133-122-135-131-19-112-121-125-90-191-51-147-150-6-188-169-132-13-195-168-126-134-118-74-182-139-11-138-33-160-144-104-8-82-111-35-109-0-29-145-15-70-3-189-155-152-34-18-62-124-106-143-55-183-140-20-148-47-94-179-99-185-86-166"
65,49480,100,21971,71451,24,"79-91-141-97-77-111-35-34-55-18-83-62-124-106-128-86-176-113-103-163-89-165-127-114-194-166-185-95-130-99-179-66-94-47-148-60-23-20-28-149-4-199-140-183-152-170-184-155-189-109-0-29-160-33-138-104-8-82-21-177-123-25-121-131-90-191-71-120-51-139-11-168-195-145-15-3-70-13-132-169-188-6-147-10-133-122-107-40-63-135-1-198-117-31-190-175-78-5-36-61"
66,48280,100,22548,70828,20,"55-34-170-152-183-140-4-149-28-20-148-47-94-66-179-185-95-86-166-194-176-113-76-137-114-103-89-127-165-163-187-186-153-81-77-141-36-78-175-80-190-45-5-177-21-82-8-104-33-138-25-121-54-31-193-117-198-1-135-102-63-100-40-107-10-133-122-131-125-90-191-51-147-134-6-188-169-132-161-70-3-155-189-15-145-13-195-168-11-29-0-109-35-111-159-143-106-124-62-18"
67,47498,100,20417,67915,18,"165-127-89-103-113-176-194-166-86-185-179-94-47-148-60-20-28-140-183-55-18-62-124-106-143-35-109-0-29-160-33-138-182-25-112-121-131-125-90-191-51-134-139-168-195-13-145-3-70-169-188-6-147-178-10-133-122-135-100-107-40-63-38-27-16-1-198-117-193-31-54-73-136-190-80-45-142-175-78-5-177-21-61-36-91-141-97-77-82-8-104-56-144-68-111-14-81-153-187-163"
68,47778,100,21596,69374,23,"194-166-86-185-179-99-130-95-55-183-140-148-47-94-60-20-28-149-4-152-155-189-3-70-161-15-145-168-195-13-132-169-188-6-147-90-122-133-107-40-100-63-135-38-27-16-1-156-198-117-193-31-54-73-190-80-175-78-5-177-25-112-121-51-118-134-139-11-138-33-160-29-0-35-109-69-34-18-62-124-106-143-41-111-144-56-104-8-82-21-141-97-77-81-153-163-89-103-113-176"
69,48283,100,22029,70312,19,"133-122-131-121-125-90-191-51-147-192-150-6-188-169-70-3-155-152-183-140-4-149-28-20-60-148-47-94-66-179-185-130-95-86-166-194-176-113-114-137-127-89-103-163-153-106-124-62-18-145-13-195-168-139-11-29-0-109-35-111-77-141-91-36-61-21-82-8-56-144-160-33-104-138-182-134-85-74-118-25-177-5-78-175-80-190-193-31-54-117-198-156-1-16-27-38-135-63-40-107"
70,49847,100,22851,72698,20,"28-140-183-62-124-106-18-55-34-3-145-168-29-0-109-35-143-153-81-111-160-33-138-182-11-139-169-188-147-191-90-51-98-74-118-121-131-122-133-10-107-40-100-63-102-135-38-27-16-1-156-198-117-193-31-54-73-190-80-162-45-142-175-78-5-25-177-36-61-79-91-141-21-104-8-82-77-97-187-163-89-127-137-114-103-113-176-166-86-95-130-185-179-66-94-47-148-60-23-20"
71,47461,100,21699,69160,21,"117-198-193-190-80-45-142-175-78-36-61-91-141-97-77-81-153-143-106-124-128-62-34-55-18-83-95-130-99-185-86-176-163-165-127-89-103-113-194-166-179-66-94-154-47-148-60-20-28-149-140-183-152-155-3-145-195-168-132-169-188-6-147-51-90-10-133-40-107-122-135-63-102-38-27-16-1-131-121-139-11-138-33-160-29-0-109-35-111-144-104-8-82-21-177-5-73-164-31-54"
72,50286,100,22832,73118,19,"13-195-168-145-15-70-3-155-184-189-29-0-109-35-18-55-34-152-140-28-20-60-148-47-185-86-95-183-83-62-124-106-166-194-176-180-113-103-89-163-153-77-97-141-61-36-5-78-175-45-80-190-73-54-31-193-117-1-27-38-135-63-100-40-107-72-10-133-44-122-90-191-147-51-125-131-121-158-25-177-21-82-8-41-111-144-104-157-33-160-49-138-182-11-139-134-6-188-169-132"
73,47754,100,21087,68841,17,"51-121-131-178-10-133-122-135-63-38-27-1-117-54-31-193-190-80-175-78-5-177-36-61-91-141-187-127-114-194-166-176-180-113-26-103-89-163-153-77-82-8-111-144-104-138-33-160-29-0-109-35-34-55-18-62-124-106-128-86-185-95-130-99-179-66-94-47-148-60-20-28-101-149-4-199-140-183-152-170-184-155-3-70-15-145-13-195-168-11-139-126-132-169-188-147-71-191-90-125"
74,47874,100,21325,69199,19,"188-195-168-11-33-160-144-29-0-109-35-111-82-21-8-104-138-182-118-51-90-122-107-40-63-135-131-121-112-19-1-197-16-38-27-42-156-198-117-193-31-54-164-73-173-136-190-80-175-5-177-36-61-91-141-77-81-153-143-124-106-163-103-89-127-114-113-176-194-166-86-110-62-18-55-34-183-95-130-99-185-179-66-94-47-148-60-20-28-140-152-184-155-3-70-15-145-13-132-169"
75,50273,100,21843,72116,20,"165-187-153-163-89-127-103-113-176-86-18-62-124-106-35-109-0-29-160-33-144-104-8-111-82-21-77-141-91-61-36-177-5-45-142-78-175-162-46-80-190-136-196-42-27-1-156-198-117-193-31-54-164-73-112-121-131-135-63-100-40-107-17-72-10-133-122-90-191-51-118-74-25-182-138-11-139-168-195-13-132-169-6-188-70-3-15-155-152-140-183-148-47-94-179-185-166-194-114-137"
76,46613,100,20037,66650,20,"34-55-18-62-124-106-35-109-0-29-160-144-111-104-157-25-121-51-98-118-182-138-33-11-139-43-168-195-126-13-145-15-3-70-161-132-169-188-6-147-191-90-122-135-63-102-38-27-1-198-117-54-73-31-193-190-80-175-78-142-5-177-36-61-91-141-21-8-82-77-81-153-163-89-165-127-137-114-103-113-176-194-166-86-95-130-185-179-94-47-148-60-20-59-28-149-4-140-183-152"
77,47089,100,20628,67717,19,"78-175-80-190-193-117-198-1-38-63-135-122-133-10-90-191-51-121-54-31-177-21-8-104-160-33-138-11-139-168-195-13-132-169-188-70-3-15-145-29-12-0-109-35-143-106-124-128-62-18-55-34-170-155-184-152-140-183-9-4-149-28-20-60-148-47-154-94-66-57-172-179-185-99-130-95-86-166-194-176-180-113-103-114-137-127-165-89-163-187-153-81-77-97-141-91-61-36-5-142"
78,50075,100,22203,72278,18,"28-149-4-140-183-152-155-3-145-195-168-169-188-147-90-122-135-32-102-63-92-38-27-16-1-156-198-117-193-31-54-73-136-190-80-162-45-173-19-112-121-131-51-98-118-134-139-11-138-104-33-160-144-111-8-82-21-177-5-142-175-78-36-141-77-81-187-127-89-103-113-194-176-163-153-119-106-143-35-0-29-109-34-55-18-62-124-128-86-95-185-166-172-179-66-94-47-148-60-20"
79,47242,100,20674,67916,23,"77-81-153-187-163-89-127-103-113-176-194-166-86-185-179-66-94-47-148-60-20-28-149-4-199-140-183-152-170-34-55-18-62-128-124-106-35-109-0-29-160-33-144-111-8-104-138-11-139-182-74-118-2-134-168-195-13-145-15-3-70-132-169-188-6-147-71-191-90-125-51-121-112-131-135-32-122-133-107-40-63-38-27-1-198-117-54-73-31-193-190-80-5-177-36-61-91-21-82-141"
80,48096,100,21907,70003,19,"20-28-149-140-183-152-170-34-0-35-109-29-168-195-145-3-70-169-188-6-134-147-178-10-133-107-40-100-122-135-63-102-38-27-16-1-156-198-117-54-73-31-193-190-80-45-175-78-5-177-25-121-131-90-191-51-98-118-182-138-33-160-104-8-111-82-21-61-36-141-77-81-153-187-163-89-127-103-113-176-194-166-86-64-119-143-106-124-128-62-18-55-95-185-179-66-94-47-148-60"
81,49107,100,22099,71206,17,"113-114-137-127-89-103-26-163-165-187-153-81-77-141-61-36-78-175-142-45-5-177-21-82-8-104-144-160-33-138-182-25-73-54-31-193-117-198-1-27-38-102-63-32-135-122-131-121-125-90-191-51-71-147-134-6-188-169-70-3-145-195-168-139-11-29-0-111-41-35-109-189-155-184-152-28-140-183-174-34-55-18-62-124-106-86-185-95-130-99-47-148-20-60-94-179-166-194-176-180"
82,48812,100,20638,69450,19,"127-137-114-103-26-113-176-88-194-166-172-179-66-94-47-148-60-20-28-149-4-152-170-34-55-18-62-83-181-183-140-95-185-86-124-106-159-143-35-109-0-29-111-144-160-33-11-139-43-168-195-13-145-15-3-70-132-169-188-6-147-71-120-51-191-90-122-135-63-38-27-1-198-117-193-31-54-121-98-118-74-182-138-25-5-177-104-8-82-21-61-36-91-141-77-81-153-187-163-89"
83,47616,100,19095,66711,20,"38-102-63-135-122-133-90-147-6-188-169-132-13-70-3-155-189-15-145-168-29-39-12-0-109-35-143-159-106-124-62-18-55-34-170-152-183-140-4-149-28-59-20-60-148-47-154-94-66-179-22-99-130-95-185-86-166-176-113-163-153-81-77-141-36-61-21-87-82-111-8-104-144-160-33-11-139-138-182-25-177-5-78-175-142-45-80-190-136-73-164-31-54-193-117-198-156-42-1-27"
84,47969,100,21300,69269,22,"89-163-187-153-77-141-82-21-91-61-36-175-5-177-25-118-98-51-121-112-54-31-73-190-80-193-117-198-156-42-1-16-27-38-135-63-40-107-133-122-90-191-147-188-169-70-3-145-13-195-168-139-11-182-138-33-49-29-109-35-0-12-160-144-56-104-8-111-50-81-143-106-124-62-18-55-34-170-152-183-140-28-20-60-148-47-154-94-66-179-185-130-95-86-166-194-176-113-103-127"
85,48589,100,22282,70871,19,"28-140-183-95-130-99-185-86-128-106-124-62-18-55-34-174-152-170-184-155-3-70-145-195-168-169-188-6-147-133-107-40-63-102-32-135-122-131-1-198-117-54-31-193-190-80-136-73-164-19-112-121-90-51-98-118-25-104-177-5-45-142-175-78-36-61-141-21-82-8-33-138-139-11-29-0-109-35-111-77-153-163-89-165-127-137-114-103-26-113-176-194-166-179-66-94-47-148-60-20"
86,48588,100,21680,70268,21,"81-153-163-89-127-114-103-113-176-194-166-172-179-66-94-47-148-20-140-183-185-86-18-62-124-106-143-111-144-160-33-49-29-0-109-35-34-55-152-184-155-3-70-15-145-13-195-168-169-188-6-134-147-178-10-133-72-107-40-100-63-135-38-27-16-1-117-193-190-80-45-175-78-5-136-73-164-31-54-19-112-121-131-122-90-191-51-118-139-11-138-104-8-82-21-61-36-141-97-77"
87,47468,100,22005,69473,19,"51-147-6-188-169-132-13-195-168-139-182-138-11-49-33-160-0-35-109-29-145-15-70-3-155-184-152-183-140-149-28-20-148-47-94-179-185-86-95-55-34-18-62-124-106-163-176-166-194-113-114-103-89-127-165-187-153-111-144-56-104-8-21-82-77-141-91-61-36-177-123-25-121-112-54-31-164-73-136-5-78-175-45-80-190-193-117-198-156-1-16-27-38-135-63-40-107-133-122-90"
88,49645,100,22267,71912,19,"182-25-112-121-131-54-31-164-73-5-175-80-190-136-193-117-1-38-135-63-40-107-10-133-122-90-51-147-6-188-169-132-161-70-3-15-145-13-126-195-168-139-11-29-0-109-35-144-111-81-143-106-124-128-86-185-99-130-95-183-174-55-18-62-34-170-189-155-184-152-140-20-148-47-94-66-179-172-52-166-194-88-176-113-114-137-103-163-89-127-165-187-153-77-82-8-104-160-33-138"
89,47279,100,21691,68970,22,"111-8-104-144-160-33-138-11-139-168-195-13-145-15-3-70-132-169-188-6-134-147-51-191-90-133-107-40-63-38-27-1-135-122-131-121-116-112-19-117-198-156-42-193-31-54-73-190-80-175-78-5-177-36-141-97-77-81-153-187-165-163-89-127-114-103-26-113-176-194-166-86-185-95-99-22-179-94-47-148-20-28-149-4-140-183-152-184-155-55-34-18-62-124-106-143-35-109-0-29"
90,47437,100,20676,68113,20,"144-104-8-21-82-111-29-0-109-35-143-106-124-128-62-18-55-34-152-183-140-28-20-60-148-47-94-99-130-95-86-185-179-166-194-176-113-103-163-153-81-77-141-61-36-78-175-142-162-80-190-136-45-5-177-25-158-121-112-19-73-54-31-193-117-198-156-42-1-38-63-40-107-122-135-131-90-125-51-120-67-191-71-147-6-188-169-132-70-3-15-145-13-195-168-139-11-138-33-160"
91,49657,100,21646,71303,21,"33-138-11-139-168-195-126-132-13-145-15-189-184-155-3-70-169-65-188-6-147-191-51-121-131-90-122-133-10-107-40-100-63-102-135-38-1-198-117-54-31-193-190-80-45-175-78-5-36-141-77-153-163-89-103-113-176-194-166-48-172-52-179-99-66-94-47-60-23-148-9-20-59-28-149-4-152-140-183-95-130-185-86-18-55-34-62-124-106-143-41-111-8-104-144-0-35-109-29-160"
92,50027,100,20867,70894,20,"124-86-95-185-179-66-94-47-148-60-20-28-149-4-140-9-183-62-18-55-34-170-152-184-155-167-189-145-15-3-70-188-169-195-168-139-11-138-182-51-191-90-133-122-63-102-135-1-131-121-112-19-151-198-117-193-31-54-164-73-136-190-80-5-177-36-61-79-91-141-21-82-111-8-104-56-144-160-33-49-29-39-12-0-109-35-143-81-77-153-187-163-89-127-114-103-113-194-176-106"
93,47060,100,20112,67172,18,"97-141-91-36-61-21-8-111-35-109-0-29-144-160-33-11-139-138-182-25-177-5-78-175-142-45-80-190-193-31-54-117-198-156-1-135-102-63-122-131-112-121-51-90-191-147-188-169-132-13-195-168-145-15-70-3-155-152-34-55-18-62-124-143-106-86-185-22-99-130-95-181-183-140-149-28-20-148-47-94-66-57-172-179-52-166-194-88-176-113-114-103-163-89-127-165-187-153-81-77"
94,48493,100,19975,68468,21,"168-145-15-70-3-155-184-152-183-140-149-28-59-20-60-148-47-154-94-66-179-185-86-166-194-176-113-103-163-106-124-62-18-55-34-109-29-160-33-49-11-139-182-138-104-144-0-35-41-111-8-82-77-97-141-61-36-177-5-78-175-80-190-136-73-164-54-31-193-117-198-156-1-16-27-38-102-63-40-107-122-32-135-131-121-112-25-74-118-98-51-90-147-6-188-65-169-132-13-195"
95,48441,100,20708,69149,19,"15-145-109-35-0-29-160-33-104-8-111-124-106-143-62-18-55-34-183-140-28-20-148-47-94-66-172-179-185-130-95-86-166-194-176-113-103-127-89-163-187-153-77-141-61-36-177-5-78-175-142-45-162-46-80-190-136-73-54-31-193-117-198-156-1-16-27-38-63-135-122-90-191-133-10-178-115-147-134-118-51-120-125-131-121-112-25-138-11-139-168-195-126-13-132-169-6-188-70-3"
96,49213,100,21139,70352,19,"3-70-15-145-195-168-169-188-147-90-122-107-40-100-63-102-135-38-1-117-193-31-54-121-25-138-11-33-160-29-144-56-104-8-111-82-21-177-5-45-190-80-162-142-175-78-36-61-141-77-153-163-89-165-127-114-103-26-113-180-176-88-194-166-64-86-185-95-130-99-179-66-94-154-47-148-60-20-28-149-4-140-183-152-170-34-55-18-62-181-110-128-124-106-159-143-35-0-109-155"
97,47605,100,22678,70283,19,"104-21-82-77-141-61-36-177-5-78-175-142-45-80-190-136-73-54-31-193-117-198-156-1-16-27-38-63-135-122-133-10-147-6-188-134-51-191-90-131-121-112-25-182-138-33-11-139-168-195-13-132-169-70-3-15-145-29-0-109-35-143-106-124-86-185-95-62-18-55-34-184-155-152-183-140-28-20-148-47-94-66-179-172-166-194-176-113-103-114-76-137-127-89-163-165-187-153-111-8"
98,50829,100,22747,73576,18,"48-76-75-137-114-127-89-165-187-141-91-61-36-5-175-80-190-193-31-54-117-198-1-121-51-191-90-131-135-102-63-40-107-122-133-10-178-147-6-188-169-132-70-3-155-184-170-152-53-167-189-15-145-168-11-138-33-160-29-0-109-35-111-8-82-77-81-153-186-163-103-113-180-176-64-106-143-124-62-18-55-34-183-140-9-148-28-20-60-47-94-66-179-22-99-95-185-86-166-194"
99,49604,100,23494,73098,19,"106-176-180-88-113-103-163-186-153-81-77-21-177-5-45-190-80-175-36-61-141-187-165-89-127-137-114-76-194-166-172-179-185-86-95-130-99-94-47-148-60-20-140-183-152-184-155-3-70-145-168-169-188-6-147-178-10-133-122-135-107-40-63-38-27-1-156-198-117-193-31-54-164-73-121-131-90-51-134-139-11-138-33-160-144-104-8-82-111-39-29-0-109-35-34-55-18-62-124-143"
100,47867,100,21805,69672,20,"149-28-20-148-47-94-66-179-166-194-176-180-113-103-114-137-127-89-163-165-187-153-77-141-91-36-61-21-82-8-111-144-104-33-138-182-11-139-134-118-51-125-131-121-112-25-177-5-175-80-190-136-73-54-31-193-117-198-156-1-16-27-38-102-135-32-63-40-122-90-191-147-6-188-169-132-168-195-145-15-70-3-155-189-29-160-0-109-35-106-124-62-18-55-86-185-130-95-183-140"
101,48992,100,22327,71319,18,"199-140-183-62-18-55-34-170-152-53-184-155-189-3-70-15-145-168-195-13-132-169-188-6-134-147-51-191-90-122-107-40-63-135-1-117-31-54-121-25-138-11-33-160-144-29-0-109-35-111-8-82-21-177-5-78-175-36-61-141-97-77-81-153-187-165-127-114-137-75-76-166-194-176-113-103-89-163-143-106-124-128-86-95-185-179-22-99-9-148-47-66-94-154-60-20-59-28-149-4"
102,48459,100,21230,69689,20,"0-109-35-111-82-8-104-33-138-11-168-195-13-132-169-188-6-134-74-118-51-121-112-54-151-131-125-90-191-147-178-10-133-122-72-107-40-100-63-135-38-27-1-198-117-193-31-73-136-190-80-162-175-78-142-45-5-177-36-61-91-141-77-153-143-106-124-62-128-86-176-113-194-166-185-95-130-179-94-47-148-60-20-28-149-140-183-55-18-34-170-152-184-155-3-70-161-15-145-29"
103,50148,100,23536,73684,19,"0-29-145-15-3-70-188-169-132-13-195-168-43-139-11-182-74-134-147-10-133-107-40-63-135-38-27-156-198-193-190-80-175-5-136-73-31-54-117-1-131-122-90-191-71-67-120-51-121-25-177-21-36-61-79-91-141-77-81-153-187-163-89-127-103-113-176-106-159-143-124-62-18-34-55-95-86-185-179-94-47-148-20-28-149-140-183-152-155-109-35-111-82-8-56-104-138-33-160-144"
104,47145,100,21632,68777,19,"155-3-70-15-145-168-195-13-132-169-188-6-147-191-90-125-51-98-121-131-135-122-133-10-107-40-63-102-38-27-16-1-156-198-117-193-31-54-73-190-80-175-78-5-177-36-61-21-8-82-77-187-163-165-127-89-103-113-176-194-166-172-179-94-47-148-60-20-28-149-140-183-95-130-99-185-86-128-124-106-143-153-111-144-160-33-138-139-11-29-12-0-35-109-189-34-62-18-55-152"
105,49115,100,22144,71259,18,"3-15-145-195-29-0-109-35-106-124-128-62-18-55-34-152-183-140-149-28-20-60-148-47-94-66-172-179-185-95-86-166-48-194-88-176-180-113-26-103-114-137-127-89-165-187-163-129-153-146-97-141-77-81-111-144-160-33-104-8-21-91-61-36-177-5-78-175-45-80-190-193-117-54-31-73-112-121-1-27-38-135-63-40-107-122-90-191-147-120-51-118-182-138-11-139-168-169-188-70"
106,47129,100,22041,69170,20,"133-107-40-63-38-27-1-198-117-193-31-54-73-136-190-80-175-5-177-36-141-77-97-187-89-127-137-114-194-166-172-179-66-94-47-148-60-20-28-149-4-140-183-174-152-170-34-55-18-62-143-159-106-124-128-95-130-99-185-86-176-113-103-163-153-81-111-144-8-82-87-21-104-33-138-139-11-29-0-35-109-189-184-155-3-145-168-195-13-132-169-188-6-147-90-51-121-131-135-122"
107,47459,100,21238,68697,19,"51-90-122-107-40-100-63-135-1-198-117-54-73-31-193-190-80-175-78-142-5-177-104-8-21-61-36-141-97-77-153-187-165-163-103-89-127-137-114-76-166-194-113-180-176-88-86-110-128-95-130-99-185-179-66-94-47-148-60-20-28-149-4-140-183-152-184-155-34-55-18-83-62-124-106-143-81-111-35-109-0-29-160-33-138-182-11-139-168-195-145-15-3-70-132-169-188-6-134-147"
108,48156,100,20867,69023,21,"198-117-151-54-73-164-31-193-190-80-175-78-5-177-36-61-91-21-82-8-104-138-33-160-144-111-81-77-141-187-165-89-127-114-103-163-153-106-176-180-113-194-166-86-185-95-130-99-179-94-47-148-20-140-183-152-170-34-55-18-83-62-128-124-143-35-109-0-12-29-168-195-126-13-145-15-155-3-70-161-132-169-188-6-134-74-118-98-51-121-131-90-133-122-135-63-38-27-1-156"
109,47440,100,20368,67808,21,"164-73-136-190-80-45-142-175-78-5-36-61-141-77-81-153-187-165-163-103-89-127-137-114-113-180-176-194-166-86-95-130-99-185-179-66-94-47-148-20-28-149-140-183-55-18-62-124-106-35-109-0-29-160-33-144-104-8-21-177-112-121-25-182-138-11-139-168-195-126-13-145-15-155-3-70-132-169-188-6-134-192-147-71-51-125-90-191-10-133-122-63-135-1-156-198-117-193-54-31"
110,47084,100,20566,67650,19,"182-25-177-5-78-175-80-190-136-73-164-31-54-193-117-198-156-24-1-27-38-135-63-40-107-133-122-191-90-131-121-51-118-74-139-11-134-6-188-169-132-168-195-145-70-3-155-152-170-34-55-18-83-62-143-106-124-128-95-183-140-149-28-20-148-47-94-185-86-166-194-176-113-114-127-89-103-163-153-81-77-141-91-36-61-21-82-8-104-56-144-111-35-109-0-12-29-160-33-138"
111,50035,100,22798,72833,19,"148-47-94-179-185-86-166-194-176-113-163-187-141-77-153-106-124-62-34-55-18-128-95-130-183-140-170-184-155-3-70-15-145-132-188-169-13-195-168-139-134-147-71-191-90-51-118-25-19-112-121-131-135-122-133-10-72-107-40-100-63-38-27-1-198-117-193-31-54-73-136-190-80-175-78-142-5-177-21-8-111-144-104-138-182-11-33-29-0-35-109-189-167-152-4-149-28-59-20-60"
112,49237,100,23596,72833,19,"27-38-135-63-40-107-122-133-10-147-169-132-13-195-168-145-3-155-152-183-140-28-20-60-148-47-94-66-179-172-166-194-113-114-75-137-127-89-165-187-97-77-141-36-61-81-153-163-103-180-176-86-185-130-95-18-55-62-124-106-143-35-109-0-29-111-82-8-104-160-33-138-182-11-139-74-25-177-5-78-175-142-45-80-190-193-31-54-73-112-121-51-125-191-90-131-117-198-156-1"
113,47633,100,22204,69837,18,"86-166-194-113-114-137-127-89-163-103-176-159-143-106-124-62-18-55-34-109-0-35-41-81-153-187-141-77-111-144-29-160-33-11-139-138-104-56-8-82-21-91-61-36-177-5-175-80-190-73-164-54-31-193-117-198-1-38-135-63-40-107-133-122-131-121-118-98-51-90-147-6-188-65-169-132-13-195-168-145-70-3-155-184-152-183-140-199-4-149-28-20-60-148-47-94-66-179-185-95"
114,49353,100,22226,71579,19,"13-132-169-70-3-15-145-29-109-35-0-160-33-138-104-8-82-111-81-153-106-124-128-62-83-18-55-34-152-95-130-9-183-140-199-149-4-28-20-60-148-47-94-66-179-99-185-86-166-176-113-103-89-163-187-97-77-58-141-91-36-61-21-177-5-78-175-142-45-25-121-54-31-164-73-80-190-193-117-198-1-27-38-135-32-122-63-40-107-133-10-90-51-98-118-134-139-11-168-195"
115,48010,100,22272,70282,18,"144-111-8-21-82-77-97-141-61-36-177-5-78-175-80-190-136-73-54-31-193-117-198-156-1-63-40-107-10-133-122-32-135-131-121-125-90-191-147-51-98-118-134-139-11-168-195-13-132-169-6-188-161-70-3-15-145-155-184-152-140-183-55-18-62-124-128-86-185-20-60-148-47-94-179-172-52-166-194-176-113-114-137-127-89-103-163-187-153-81-106-143-35-109-0-29-160-33-138-104"
116,48469,100,21099,69568,21,"100-122-133-10-178-90-191-71-120-51-118-74-134-43-168-195-13-169-188-192-147-6-132-145-15-70-3-155-184-152-183-140-4-149-28-20-60-148-47-94-179-185-95-18-62-124-86-166-194-176-113-114-137-127-165-89-103-26-163-187-153-77-111-35-109-0-29-49-11-139-182-138-33-160-144-104-8-82-21-61-36-177-5-175-80-190-193-31-73-54-117-198-156-1-121-131-135-63-40-107"
117,48533,100,22157,70690,18,"165-89-163-176-86-95-183-140-174-34-55-18-62-124-106-35-109-0-29-111-81-153-77-97-141-91-61-36-177-21-82-8-104-160-33-11-138-182-118-98-51-121-54-73-136-45-5-142-78-175-162-80-190-164-31-193-117-198-1-38-135-102-63-40-107-133-122-90-191-147-134-139-168-195-6-188-65-169-132-13-145-15-70-3-155-152-4-149-28-20-60-148-47-94-185-166-194-113-103-127"
118,48909,100,22681,71590,20,"1-16-27-38-63-40-107-133-122-135-131-90-191-120-71-147-6-188-169-132-70-3-155-15-145-13-195-168-134-139-11-138-104-8-21-87-82-111-160-33-29-0-109-35-143-106-124-128-86-62-18-55-152-28-140-183-95-130-185-99-148-20-60-47-94-179-166-194-176-180-113-103-89-163-153-81-77-97-141-61-36-175-5-177-25-74-118-98-51-121-112-19-136-80-190-73-54-31-193-117"
119,49100,100,20364,69464,20,"102-63-135-122-133-10-90-191-51-120-71-147-188-169-70-3-15-145-195-168-139-11-138-33-104-144-160-39-29-0-109-35-143-106-124-62-18-55-34-152-95-86-185-99-130-183-140-28-20-148-47-94-66-179-172-52-166-194-176-180-113-103-163-89-127-165-187-186-153-81-14-111-68-8-21-82-77-141-91-61-36-5-78-175-45-80-190-193-31-54-73-121-131-117-198-156-42-1-27-38"
120,49101,100,22870,71971,19,"62-95-183-140-148-66-94-47-60-23-20-28-149-152-55-18-34-184-155-15-3-70-132-169-188-147-90-122-133-107-40-100-63-135-38-1-156-198-117-193-190-80-73-31-54-19-112-121-131-51-98-118-74-134-168-195-145-29-109-35-0-160-33-11-139-138-104-144-8-82-21-25-177-5-45-142-175-78-36-61-141-97-77-81-153-163-89-127-114-103-113-180-176-194-166-185-86-128-106-124"
121,50149,100,21745,71894,19,"119-163-103-89-127-137-165-187-153-81-77-141-36-78-175-45-80-190-193-117-198-156-42-27-38-16-1-54-31-164-73-5-177-21-82-111-35-109-0-29-160-144-56-8-104-33-138-182-11-139-2-134-74-118-121-51-90-122-133-10-147-6-188-65-169-132-13-195-168-145-15-70-3-155-184-152-140-149-28-20-148-47-185-166-194-113-176-86-95-130-183-174-34-55-18-62-128-124-106-143"
122,51111,100,22224,73335,18,"147-51-98-118-134-6-188-169-161-70-3-15-145-13-132-126-195-168-43-139-11-33-160-39-29-12-0-35-109-189-155-184-152-28-20-148-140-183-34-55-18-83-62-143-106-124-128-64-86-95-130-99-185-179-166-194-176-113-114-103-89-127-165-163-153-81-77-141-61-36-5-177-21-82-68-111-144-8-104-138-25-73-54-31-193-117-1-27-38-131-121-90-122-135-63-40-107-133-10-178"
123,48428,100,19761,68189,23,"177-5-175-80-190-136-73-164-31-54-151-193-117-198-1-131-121-118-98-51-120-67-71-191-90-125-122-135-63-40-107-133-10-147-6-188-169-132-13-195-168-145-15-70-3-189-155-184-152-53-170-34-55-18-83-62-124-106-128-183-140-199-149-4-28-20-148-47-94-179-185-99-130-95-86-166-194-176-180-113-103-89-163-187-153-111-35-109-0-29-144-160-33-11-138-104-8-21-61-36"
124,48501,100,20897,69398,20,"125-51-98-118-74-25-104-56-144-8-21-87-82-111-41-35-109-0-29-160-33-138-11-139-168-195-13-132-169-188-70-3-155-152-140-183-18-62-124-106-128-86-185-95-130-20-148-47-94-179-172-52-166-194-176-113-114-127-89-103-163-153-81-77-97-141-61-36-177-5-78-175-80-190-136-73-164-31-54-193-117-198-156-1-16-27-38-63-100-40-107-133-10-147-191-90-122-135-131-121"
125,49128,100,22419,71547,19,"21-61-36-5-78-175-45-80-190-136-73-164-54-31-193-117-198-156-1-135-63-122-133-90-131-121-118-98-51-191-147-134-139-43-168-195-13-132-169-70-3-15-145-189-155-184-152-170-34-18-55-183-140-28-20-148-47-94-179-185-130-95-86-166-194-114-103-113-180-176-128-62-124-106-153-163-89-127-165-187-77-81-14-143-35-109-0-29-160-144-111-82-8-104-33-11-138-182-25-177"
126,48702,100,21511,70213,20,"13-195-168-11-139-134-74-118-98-51-90-191-147-178-10-133-122-100-107-40-63-102-135-38-27-131-121-112-19-173-73-54-117-198-1-156-193-31-164-136-190-80-175-78-5-36-141-77-81-153-163-89-165-127-103-113-176-194-166-86-185-94-47-148-20-28-149-4-140-183-152-170-34-55-18-62-124-106-35-109-0-111-104-8-82-21-177-25-182-138-33-160-29-145-15-3-70-188-169-132"
127,49233,100,22561,71794,20,"34-124-106-143-62-18-55-140-183-95-130-99-148-20-60-47-94-179-185-86-166-176-113-103-163-153-81-77-97-141-36-61-21-82-8-104-138-33-160-144-111-35-109-0-29-11-139-168-195-134-74-98-118-25-177-5-78-175-142-45-162-80-190-136-73-164-31-54-193-117-198-112-121-116-51-125-131-1-16-27-38-135-32-122-63-40-107-133-10-90-147-6-188-169-70-3-15-145-155-152"
128,48324,100,21533,69857,18,"55-18-62-124-128-86-95-130-183-140-4-149-28-20-60-148-47-94-66-99-185-179-172-166-194-113-114-75-137-127-165-187-153-163-89-103-176-106-143-35-109-0-29-111-144-160-33-138-104-8-21-87-82-77-97-141-61-36-177-5-175-80-190-73-54-31-193-117-198-121-51-191-90-122-133-10-178-147-134-74-182-11-139-43-168-195-13-132-169-6-188-161-70-3-15-145-155-184-152-34"
129,47243,100,20809,68052,19,"134-139-11-182-138-33-160-144-111-104-8-82-21-61-36-141-77-153-146-187-163-89-127-103-113-180-176-194-166-179-185-86-95-99-94-47-148-60-23-20-28-149-4-140-183-152-34-55-18-62-124-106-143-35-109-0-29-168-145-3-70-13-132-169-188-6-147-90-10-133-122-135-32-96-63-102-38-27-16-1-156-198-117-193-31-54-73-190-80-45-175-78-5-177-25-112-121-131-51-118"
130,52483,100,21829,74312,19,"11-43-168-195-126-13-132-169-188-70-3-15-145-155-34-18-55-183-140-28-20-60-148-47-94-185-86-62-124-106-176-113-103-89-127-165-163-187-146-153-81-14-77-97-141-36-21-87-82-8-111-37-35-109-0-29-160-144-104-25-112-19-54-31-73-136-80-190-193-117-198-156-1-131-121-51-125-122-135-63-40-107-133-10-90-191-120-71-147-6-134-85-98-118-74-139-182-138-33-49"
131,47752,100,20795,68547,23,"20-60-148-47-94-179-185-99-130-95-86-166-194-176-180-113-103-127-89-163-153-81-77-111-8-82-87-21-141-91-61-36-175-78-5-177-25-112-121-131-54-31-164-73-80-190-193-117-198-156-42-1-27-38-63-135-122-44-133-10-147-191-90-125-51-118-74-134-6-188-169-132-161-70-3-155-184-189-15-145-13-195-168-139-11-138-33-29-0-109-35-143-106-124-62-18-55-183-140-28"
132,50249,100,21543,71792,18,"61-36-79-91-141-77-153-81-111-35-109-34-55-18-62-128-124-106-163-89-127-103-113-176-194-166-86-185-179-94-148-20-140-183-152-155-15-3-70-188-169-132-195-168-29-0-160-144-68-8-104-157-33-11-139-138-182-74-118-51-121-125-90-191-120-71-147-10-133-122-72-107-40-100-63-135-131-1-16-38-27-42-156-198-117-54-73-31-193-190-80-45-142-175-78-5-177-21-87-82"
133,47483,100,21975,69458,23,"80-175-78-5-36-61-177-25-138-33-160-29-0-109-35-111-144-104-8-82-87-21-141-97-77-81-153-187-163-165-127-89-103-114-113-176-194-166-179-94-47-148-60-20-140-183-95-130-185-86-124-106-159-143-62-18-55-34-152-184-155-189-3-70-15-145-13-195-168-169-188-6-147-191-90-51-98-74-118-121-112-131-1-135-122-133-107-40-63-38-27-156-198-117-193-54-31-164-73-190"
134,49487,100,21575,71062,20,"103-89-163-153-81-111-82-77-141-91-36-61-21-177-5-78-175-80-190-193-31-73-54-117-1-38-135-63-100-40-107-72-10-133-122-90-191-71-147-150-6-188-169-161-70-3-15-145-195-168-126-13-132-134-118-51-125-131-121-112-25-182-138-139-11-49-33-104-8-160-29-12-0-35-109-189-155-184-170-152-140-183-148-47-94-179-185-130-95-55-34-18-62-124-106-86-166-194-176-113"
135,47521,100,20408,67929,20,"81-77-111-144-56-104-8-82-21-61-36-177-5-78-175-80-190-193-31-73-54-117-198-156-1-16-27-38-102-32-63-40-107-10-133-122-135-131-90-191-125-51-121-25-182-138-139-11-49-33-160-39-12-0-35-109-29-168-195-132-169-188-70-3-155-152-34-55-18-62-124-106-128-95-183-140-28-20-60-148-47-94-66-179-22-99-130-185-86-166-194-176-113-103-114-127-89-163-187-153"
136,47447,100,20327,67774,21,"63-102-38-27-16-1-198-117-54-31-193-190-80-175-78-5-177-138-11-33-160-104-8-111-82-21-61-36-91-141-97-77-81-153-186-187-163-165-127-89-103-113-176-88-194-166-86-95-130-185-179-66-94-47-148-60-20-59-28-149-4-152-140-183-174-34-55-18-62-124-106-143-35-109-0-29-168-195-145-3-70-169-188-6-147-191-90-125-51-98-121-112-131-135-32-122-133-10-107-40"
137,48604,100,22586,71190,20,"138-182-25-177-5-78-175-36-61-91-141-77-153-187-163-103-89-127-137-114-113-176-88-194-166-52-172-179-94-47-148-20-28-140-183-95-130-185-86-128-124-62-83-18-55-34-152-184-155-189-3-70-15-145-13-195-168-169-188-147-115-178-10-133-191-90-122-107-40-63-135-38-1-198-117-193-80-190-73-31-54-121-51-98-118-134-139-11-33-160-29-0-109-35-106-143-111-82-21-8"
138,48527,100,21876,70403,17,"86-185-130-95-183-140-152-4-149-28-59-20-60-154-94-66-47-148-9-99-22-179-172-166-194-176-180-113-103-127-89-163-187-153-77-81-119-159-143-35-109-0-29-111-82-141-91-36-61-21-8-104-144-160-33-138-25-177-5-78-175-80-190-193-54-31-164-73-112-121-117-198-1-135-63-100-40-107-122-90-191-51-147-6-188-169-132-168-195-145-15-70-3-34-55-18-62-124-106-128"
139,48843,100,22391,71234,18,"114-103-26-113-176-194-166-172-179-185-99-94-47-148-20-28-140-183-130-95-86-128-124-106-119-159-143-62-18-55-34-170-152-184-155-15-3-70-188-169-132-195-168-139-134-6-147-51-125-191-90-131-135-32-122-178-10-133-107-40-100-63-38-27-1-198-117-193-31-54-121-25-138-11-29-109-35-0-160-33-104-8-111-82-21-177-5-142-175-78-36-141-77-81-153-187-163-89-127-137"
140,48835,100,21116,69951,20,"103-163-153-81-77-82-111-144-0-35-109-29-160-33-56-104-8-21-61-36-175-80-190-193-31-54-117-1-27-38-131-121-125-191-90-122-135-63-100-40-107-133-10-147-120-51-98-118-182-138-11-139-134-6-188-169-43-168-195-13-132-145-15-70-3-155-184-152-34-55-18-62-124-106-128-181-95-185-130-183-140-149-28-20-60-148-47-94-179-172-52-86-166-194-88-176-113-114-127-89"
141,48746,100,21044,69790,20,"163-89-103-113-180-176-194-166-106-124-62-18-95-86-185-94-47-148-20-28-149-140-183-174-55-34-170-152-184-155-167-189-29-0-109-35-111-144-160-49-11-139-168-195-13-145-15-3-70-132-169-188-6-147-10-133-44-122-90-191-51-98-74-118-116-121-131-135-72-107-40-100-63-1-117-54-73-31-193-190-80-175-78-5-177-25-182-138-33-104-8-82-21-61-36-91-141-77-81-153"
142,47399,100,20402,67801,21,"188-147-10-133-72-17-107-40-100-63-122-135-38-27-16-1-156-198-117-193-54-31-164-73-136-190-80-175-78-5-36-177-25-112-121-90-191-51-118-139-11-138-104-8-160-33-49-29-0-109-35-111-77-153-187-165-127-89-163-103-113-176-88-194-166-179-66-94-47-148-60-20-28-149-4-140-183-95-130-99-185-86-128-106-124-62-18-55-34-152-184-155-3-70-15-145-13-195-168-169"
143,47852,100,20805,68657,21,"188-169-132-13-195-168-145-15-70-3-189-155-184-152-170-34-55-18-62-183-140-4-149-101-28-20-23-60-148-47-94-66-179-185-86-166-194-176-113-103-163-89-127-165-187-153-106-124-143-35-109-0-29-39-160-33-144-104-8-21-82-111-81-77-97-141-91-79-61-36-177-5-175-80-190-193-31-54-117-198-1-135-102-63-40-107-122-131-121-98-118-182-138-11-139-85-51-90-191-147"
144,49240,100,20768,70008,19,"33-104-8-82-111-29-0-35-109-152-140-28-20-148-47-94-183-34-55-18-62-124-106-86-185-99-179-172-52-166-194-176-180-113-103-89-163-187-153-77-141-36-177-5-78-175-142-45-80-190-136-73-164-54-31-193-117-198-156-27-38-16-1-19-112-121-131-135-32-102-96-63-40-107-122-133-10-178-191-90-125-51-147-134-6-188-65-169-132-13-161-70-3-15-145-195-168-139-11-138"
145,49266,100,21570,70836,20,"165-127-89-163-103-113-176-166-86-185-179-94-47-148-60-20-28-149-140-183-130-95-18-55-152-53-170-34-62-128-124-106-143-111-82-8-104-56-144-160-39-12-0-35-109-69-29-49-33-138-182-11-139-168-195-145-15-189-155-3-70-169-188-6-134-147-10-133-122-63-135-131-90-51-98-118-121-112-19-1-156-198-117-54-31-193-190-80-175-5-177-36-61-91-141-97-77-81-153-187"
146,46229,100,21144,67373,20,"81-153-187-163-103-89-127-114-113-180-176-194-166-86-185-179-66-94-47-148-20-28-149-4-140-152-34-183-130-95-18-62-124-106-143-35-109-0-29-160-33-138-182-11-139-168-195-13-145-15-155-3-70-132-169-188-6-147-51-90-125-121-112-131-135-122-133-10-107-40-100-63-38-27-1-156-198-117-54-73-164-31-193-190-80-45-142-175-78-5-177-36-61-21-82-8-111-77-141-97"
147,47828,100,20756,68584,23,"180-176-194-166-86-128-106-124-62-18-55-34-183-95-185-179-94-47-148-60-20-28-149-4-140-152-155-3-70-145-168-195-13-132-169-188-6-134-118-98-51-121-131-135-122-90-191-147-178-10-133-72-107-40-100-63-38-27-16-1-156-198-117-31-190-80-175-78-142-5-177-36-61-141-77-82-21-8-104-160-33-138-182-139-11-29-109-35-0-12-39-144-111-41-81-153-163-89-103-113"
148,48063,100,22116,70179,20,"97-141-61-36-78-175-80-190-45-5-177-21-82-111-8-104-33-138-11-139-51-125-191-90-122-32-135-131-121-112-73-54-31-193-117-198-156-42-1-27-38-63-100-40-107-133-10-147-6-188-169-132-70-3-145-195-168-29-0-35-106-124-128-62-18-55-34-152-4-149-28-20-60-94-66-179-47-148-199-140-183-95-130-99-185-86-166-194-176-113-26-103-114-127-89-163-187-153-81-77"
149,48402,100,21349,69751,21,"27-1-156-198-117-193-54-31-164-73-25-182-138-139-11-33-104-8-82-21-177-5-45-142-175-78-36-61-91-141-77-97-187-127-114-113-194-166-88-176-26-103-89-163-153-81-14-111-144-160-29-0-109-35-34-55-18-62-143-106-124-128-110-86-185-95-130-99-179-66-94-47-148-60-20-140-183-152-155-3-70-145-195-168-132-169-188-6-147-51-121-131-90-191-10-133-122-135-63-38"
150,47732,100,19571,67303,19,"165-127-137-114-76-113-180-176-88-194-166-172-179-66-94-47-148-20-28-140-183-95-130-185-86-55-34-18-62-124-106-143-35-109-0-29-160-33-8-104-138-11-139-134-43-168-195-13-145-15-3-70-132-169-188-6-150-147-120-51-98-121-131-125-90-191-178-10-133-122-135-63-102-38-27-1-156-198-117-54-31-193-190-80-175-78-142-5-177-36-61-141-77-81-153-187-163-26-103-89"
151,47838,100,21266,69104,19,"106-159-143-35-109-29-0-37-111-144-160-33-11-139-168-195-145-15-189-170-152-155-3-70-132-169-188-6-147-133-63-135-122-90-191-51-121-131-1-198-117-54-73-164-31-193-190-80-45-175-78-5-36-61-91-21-177-123-25-182-138-104-56-8-82-141-97-77-81-153-163-89-127-137-114-103-113-176-194-166-86-95-185-179-66-94-47-148-20-28-149-140-183-174-34-55-18-62-128-124"
152,48266,100,21898,70164,20,"13-70-3-15-155-189-145-195-168-139-11-29-0-109-35-34-170-152-183-140-28-20-60-148-47-94-66-179-185-86-130-95-55-18-62-124-106-176-113-194-166-76-114-137-127-165-89-103-163-187-153-81-77-141-21-82-8-104-33-138-182-118-51-121-112-19-25-177-5-175-80-190-136-73-164-54-31-193-117-198-156-24-1-16-27-38-63-135-122-131-125-90-191-133-10-147-6-188-169-132"
153,48093,100,21815,69908,21,"179-94-47-148-130-95-185-86-106-124-62-18-55-183-20-28-140-152-155-3-70-15-145-109-35-0-29-160-33-138-182-11-139-43-168-195-126-13-132-169-188-6-134-85-147-51-125-191-90-122-178-10-133-72-107-40-100-63-135-131-121-117-193-31-54-73-190-80-45-175-78-5-177-25-104-8-56-144-111-82-21-61-36-91-141-97-77-81-153-163-103-89-127-137-114-113-176-194-166-172"
154,50369,100,20591,70960,18,"34-18-62-183-140-4-149-28-59-20-23-60-148-47-94-66-172-179-99-185-86-166-194-113-180-176-106-124-143-103-89-127-165-163-153-81-77-97-141-91-61-36-78-175-142-5-177-21-82-58-50-111-41-37-35-109-0-12-29-144-8-104-160-33-138-182-25-121-54-31-193-117-198-1-27-38-102-63-135-122-133-90-191-51-118-134-147-6-188-169-132-13-195-168-145-15-161-70-3-155"
155,48467,100,22481,70948,21,"8-104-25-177-5-80-190-73-54-31-193-117-1-16-27-38-135-102-63-40-107-122-133-10-147-6-188-134-51-90-131-121-118-182-138-11-139-168-195-132-169-70-3-15-155-184-152-170-34-55-18-62-83-183-140-4-149-28-20-148-47-94-66-179-185-22-99-130-95-86-166-194-176-113-114-137-127-89-103-163-153-106-128-124-159-143-35-109-0-29-49-33-160-144-111-81-77-141-36-21"
156,48753,100,22450,71203,19,"45-190-80-162-175-78-36-61-141-77-187-163-89-103-113-194-166-88-176-153-81-82-111-29-0-109-35-143-106-124-128-86-185-94-47-148-20-28-140-183-95-62-18-55-34-170-152-184-155-3-70-15-145-195-168-11-139-13-132-169-188-6-134-147-191-90-10-133-72-107-40-100-122-135-63-102-38-27-1-156-198-117-193-31-54-121-51-98-118-182-138-33-160-144-56-104-8-21-177-5"
157,50508,100,21136,71644,20,"21-87-82-68-8-104-138-182-139-11-33-160-144-111-35-109-0-12-39-29-189-184-155-84-70-161-3-15-145-195-168-126-13-132-169-65-188-6-147-51-90-122-133-107-40-63-135-38-27-1-198-117-193-190-80-175-78-142-5-73-31-54-151-19-112-121-158-25-177-36-61-91-141-153-113-176-166-86-185-95-99-22-179-94-47-148-60-20-28-149-140-183-34-55-18-62-124-106-81-77"
158,48286,100,22227,70513,21,"20-60-148-47-94-99-130-185-179-57-172-166-194-113-103-89-127-165-187-153-163-176-86-95-83-18-62-124-106-159-143-35-109-0-29-111-144-160-33-49-11-139-138-182-74-118-121-25-104-8-82-77-141-61-36-177-5-78-175-80-190-136-73-164-54-31-193-117-198-30-42-156-1-27-38-135-63-40-107-133-122-90-191-51-147-6-188-169-168-195-145-15-70-3-155-152-34-55-183-140"
159,48710,100,21942,70652,21,"163-153-81-77-141-61-36-175-78-5-177-25-121-112-73-190-80-193-31-54-117-198-1-27-38-135-102-63-100-40-107-72-133-10-115-178-122-90-191-125-51-147-134-139-11-138-104-8-111-144-160-33-168-195-145-13-132-169-70-3-155-184-152-170-34-55-18-35-109-29-0-37-143-159-106-124-62-95-183-140-149-28-20-60-148-47-94-66-179-99-185-86-166-194-176-113-103-114-127-89"
160,47683,100,21550,69233,18,"168-195-13-70-3-15-145-189-155-184-152-170-34-106-124-62-18-55-183-140-149-28-20-148-47-94-179-185-86-166-194-176-113-103-114-137-127-89-163-187-153-81-50-82-58-77-97-141-36-61-21-8-104-144-111-41-119-159-143-35-109-0-29-160-33-11-139-138-25-177-5-78-175-80-190-136-73-164-31-54-193-117-198-156-1-121-51-131-135-63-40-107-122-90-191-147-6-188-169-132"
161,49401,100,20013,69414,18,"106-159-143-124-128-62-83-18-55-34-35-109-0-29-160-144-8-104-33-145-3-70-188-169-132-13-195-168-139-11-138-182-25-121-118-98-51-120-125-90-191-147-178-10-133-122-135-1-117-193-31-54-164-73-136-190-80-175-78-142-45-5-36-61-79-91-141-21-87-82-77-81-153-163-165-127-89-103-114-113-176-194-166-172-179-185-99-66-94-47-148-60-20-28-140-183-130-95-86-64"
162,48682,100,22539,71221,21,"103-163-89-127-114-194-166-86-185-95-130-99-179-66-94-47-148-60-23-20-28-140-183-62-18-55-34-152-155-189-145-15-3-70-169-132-13-195-168-43-134-188-6-147-51-191-90-133-122-135-63-38-27-1-24-156-42-198-117-193-190-80-175-78-5-73-31-54-112-121-25-182-138-139-11-49-33-104-8-21-36-141-97-187-153-81-77-82-111-144-160-29-0-109-35-106-124-128-176-113"
163,49605,100,21240,70845,20,"135-32-100-107-40-63-38-1-156-42-30-198-117-193-190-80-162-45-136-73-164-31-54-151-121-112-19-158-25-177-5-142-175-78-36-61-141-97-77-81-153-163-89-165-127-114-103-26-113-180-176-194-166-179-94-47-148-60-20-130-95-185-86-128-124-106-119-159-143-62-18-55-183-140-152-34-35-109-0-29-160-33-8-104-138-11-139-168-195-145-3-70-132-169-188-6-147-90-133-122"
164,47543,100,20517,68060,19,"183-152-184-155-170-34-55-18-62-95-130-99-185-128-124-106-143-111-8-104-144-12-0-35-109-29-39-160-33-138-182-11-139-168-145-15-3-70-132-169-188-6-147-10-133-122-90-191-51-121-131-135-1-156-198-117-54-31-193-190-80-45-175-78-5-177-21-36-61-79-91-141-77-81-153-163-103-89-165-127-137-114-113-194-180-176-64-86-166-172-179-94-47-148-60-20-28-149-4-140"
165,50753,100,22734,73487,20,"28-149-4-199-140-183-95-86-64-106-124-128-62-18-55-34-152-155-3-70-188-169-132-13-195-168-29-109-35-0-39-49-33-160-144-56-8-104-138-182-11-139-74-118-121-131-90-191-125-51-134-6-147-133-40-107-122-135-63-38-27-1-117-31-190-80-175-78-5-177-36-61-91-21-82-111-143-159-81-14-50-77-141-97-153-187-163-89-103-113-176-194-166-185-179-66-94-47-148-20"
166,48744,100,20587,69331,20,"77-141-91-61-36-177-5-78-175-80-190-193-54-31-164-73-19-112-121-117-198-156-42-1-27-38-63-135-122-133-10-147-192-188-70-3-15-145-168-195-13-132-169-6-191-90-51-134-139-182-138-11-33-160-39-29-12-0-109-35-143-106-124-62-18-55-183-140-149-28-20-60-148-47-94-185-86-166-194-176-113-114-137-127-165-89-103-163-187-153-81-14-111-144-56-104-8-21-87-82"
167,46836,100,20591,67427,19,"153-81-77-97-141-91-36-61-21-82-8-104-56-111-144-160-33-138-182-118-51-121-25-177-5-78-175-80-190-136-73-54-31-193-117-198-1-38-63-135-122-133-10-90-191-147-6-188-169-132-13-161-70-3-15-145-195-168-11-29-0-35-109-189-167-155-184-152-140-4-149-28-20-60-148-47-94-179-185-95-183-174-34-55-18-83-62-124-106-86-166-194-176-113-114-137-127-89-103-163"
168,47611,100,20967,68578,19,"170-34-55-18-62-124-106-35-109-0-29-189-155-3-70-161-15-145-168-195-13-132-169-188-6-147-178-10-133-107-40-100-122-135-63-38-27-1-131-121-125-90-191-51-134-139-11-138-182-25-177-73-164-31-54-117-193-190-80-162-175-78-142-45-5-36-61-21-82-8-104-33-160-111-77-81-153-163-89-103-113-176-88-194-166-86-185-179-94-47-148-60-23-20-28-149-4-140-183-152"
169,46711,100,19970,66681,19,"185-130-95-86-166-194-176-180-113-103-89-127-114-137-165-163-187-153-77-141-91-61-36-177-5-78-175-45-80-190-136-73-164-54-31-193-117-198-1-135-63-122-133-10-90-191-51-121-112-19-158-25-182-138-104-8-21-82-111-144-160-33-11-139-168-195-13-132-169-188-70-3-15-145-29-12-0-109-35-143-119-106-124-128-62-18-55-34-152-183-140-4-149-28-20-60-148-47-94-179"
170,49110,100,21566,70676,19,"176-88-194-166-52-179-172-57-66-94-154-47-148-60-23-20-28-140-183-152-155-3-70-15-145-195-13-132-169-188-6-134-147-51-121-90-122-135-63-38-27-1-156-198-117-193-54-31-164-73-136-190-80-175-78-5-177-36-61-21-104-138-139-168-11-33-144-8-77-81-111-160-29-0-109-35-37-143-124-62-18-34-55-95-130-185-86-64-106-129-153-187-163-103-89-127-137-114-113-180"
171,48260,100,21544,69804,18,"144-111-81-153-163-89-127-137-114-103-113-176-194-166-86-95-130-185-179-172-66-94-47-148-60-20-28-140-183-152-184-155-170-34-55-18-83-62-124-106-159-143-69-109-35-0-29-49-160-33-138-182-11-139-168-145-3-70-169-188-6-147-191-90-133-122-135-63-38-27-16-197-1-156-198-117-193-54-31-164-73-136-190-80-175-78-45-121-51-118-25-177-5-36-61-141-77-82-8-104"
172,48294,100,22446,70740,21,"74-139-182-25-157-138-11-33-160-104-8-82-87-21-177-36-61-79-91-141-77-97-187-165-127-89-163-103-113-176-194-166-86-95-185-179-94-47-148-60-20-28-140-183-152-34-55-18-62-128-124-106-143-119-153-81-111-144-0-35-109-29-145-15-3-70-188-169-132-13-195-168-134-6-147-90-122-133-107-40-100-63-135-38-1-198-117-193-190-80-175-5-136-73-31-54-112-121-51-118"
173,49871,100,21380,71251,19,"104-144-160-33-138-182-11-139-134-74-118-51-125-191-90-122-131-121-112-19-158-25-177-5-78-175-142-45-80-190-136-73-164-31-54-193-117-198-156-24-1-38-135-63-100-40-107-133-10-147-188-169-132-13-195-168-145-15-70-3-155-184-152-140-28-20-183-34-55-18-62-124-109-29-12-0-35-143-106-86-185-166-194-176-113-103-89-163-153-81-111-77-97-141-91-36-61-21-82-8"
174,48267,100,21377,69644,20,"155-34-143-106-124-62-18-55-183-140-149-28-20-60-148-47-94-179-185-130-95-86-166-194-88-176-113-114-103-89-127-165-163-187-153-97-77-81-111-35-109-0-29-49-11-139-182-138-33-160-144-56-104-8-82-87-21-141-91-61-36-177-25-158-121-54-31-73-136-45-5-175-80-190-193-117-198-1-27-38-135-63-40-107-122-90-191-125-51-98-118-74-134-6-188-169-168-145-70-3"
175,49224,100,23289,72513,19,"55-174-140-183-95-130-99-185-179-172-57-66-94-47-148-60-20-59-28-149-4-152-155-3-70-145-168-195-13-132-169-188-6-147-90-122-63-135-131-121-51-118-134-43-139-11-182-138-33-160-104-8-177-5-73-31-54-1-38-27-198-117-193-190-80-45-175-78-36-61-91-141-77-187-127-137-114-194-166-86-176-88-113-103-89-163-153-106-124-143-111-144-29-0-109-35-34-18-62-83"
176,50039,100,21132,71171,20,"138-104-56-144-160-33-49-11-139-168-195-13-145-15-70-3-155-184-189-34-62-83-18-55-152-149-28-20-148-47-94-140-183-95-185-179-86-166-194-88-176-180-113-114-103-89-127-165-163-153-106-124-143-35-109-0-29-39-111-8-82-77-141-36-61-21-177-5-78-175-45-80-190-136-73-31-193-117-54-121-131-1-27-38-63-135-122-133-10-178-147-71-67-120-191-90-125-51-118-182"
177,48907,100,22075,70982,22,"112-121-51-125-90-191-147-134-6-188-169-168-145-15-70-3-155-189-29-0-109-35-111-143-159-106-124-128-62-18-55-34-170-152-140-183-95-130-99-148-4-149-28-20-60-47-94-179-185-86-176-113-103-89-127-165-163-153-81-77-141-61-36-177-21-8-104-160-33-138-182-25-5-142-78-175-80-190-73-164-54-31-193-117-198-156-42-16-27-38-135-102-63-100-40-107-122-131-1-19"
178,49196,100,23323,72519,18,"42-156-24-1-38-135-102-63-40-122-90-51-121-25-138-104-21-82-8-111-144-33-160-0-35-143-109-29-195-168-134-118-98-147-6-188-169-132-126-13-145-15-70-3-155-152-140-28-20-60-94-47-148-183-95-130-99-185-179-172-166-194-114-127-89-163-103-113-176-86-128-62-18-55-34-124-106-153-81-77-97-141-91-61-36-177-5-78-175-45-80-190-136-73-164-31-54-193-117-198"
179,47813,100,19639,67452,20,"74-118-98-51-121-131-90-122-135-32-63-96-102-38-27-16-1-198-117-54-31-193-190-80-175-78-142-5-177-21-87-61-36-91-141-77-81-153-187-163-89-127-114-103-113-180-176-194-166-86-110-128-124-106-159-143-62-18-34-55-95-130-185-179-52-172-66-94-47-148-20-28-140-183-152-184-155-145-15-3-70-188-169-195-168-139-11-33-160-29-0-109-35-144-111-82-8-104-138-182"
180,47486,100,20895,68381,21,"147-10-133-107-40-63-102-32-135-122-90-191-125-51-121-131-1-156-198-117-54-73-31-193-190-80-45-175-78-5-177-36-61-21-8-104-144-33-138-182-139-11-160-29-0-109-35-34-55-18-83-62-124-106-143-153-81-77-141-187-165-89-127-137-114-103-163-129-176-180-113-194-166-86-185-130-95-183-140-94-47-148-20-28-101-149-4-152-184-155-3-70-15-145-195-168-132-169-188-6"
181,48499,100,22821,71320,20,"94-66-179-172-166-185-130-95-86-128-106-124-62-18-55-34-170-155-3-70-132-169-188-6-134-147-133-122-63-38-27-1-135-90-51-121-131-198-117-193-31-54-73-136-190-80-45-142-175-78-5-177-36-61-91-141-77-82-21-8-111-14-81-153-146-187-163-89-165-127-114-103-113-194-176-129-143-35-109-0-29-160-33-138-182-11-139-168-195-13-145-15-184-152-183-140-20-60-148-47"
182,47202,100,21387,68589,20,"177-21-82-8-104-138-182-25-112-121-131-135-32-102-63-100-40-107-133-122-90-191-125-51-147-6-188-169-132-70-3-155-15-145-13-195-168-139-11-49-33-160-144-111-29-0-109-35-143-159-106-124-62-18-55-34-152-140-183-95-130-99-148-20-60-47-94-66-179-185-86-166-194-176-180-113-103-114-137-127-165-89-163-153-81-77-141-36-78-175-80-190-193-156-198-117-54-31-73-5"
183,46930,100,21636,68566,19,"31-193-190-80-45-175-78-5-136-73-121-51-139-11-182-138-33-160-29-0-109-35-111-144-56-104-8-82-21-25-177-36-61-91-141-97-77-81-143-106-153-187-163-89-127-137-114-103-113-176-194-166-86-185-99-22-179-66-94-154-47-148-60-20-28-149-140-183-55-18-62-124-34-170-152-184-155-3-70-15-145-168-195-13-132-169-188-6-147-191-90-122-135-63-102-38-27-1-117-54"
184,49710,100,22502,72212,17,"28-199-9-140-183-95-130-99-185-86-62-18-55-152-155-3-70-145-132-169-188-6-147-71-120-191-90-125-51-134-168-195-139-11-138-104-144-33-160-29-0-109-35-111-8-82-21-177-25-158-112-121-131-135-122-133-178-115-10-107-40-63-38-1-198-117-193-31-54-73-190-80-175-36-61-91-141-97-77-143-124-106-153-187-165-127-89-163-103-113-176-88-194-166-179-66-94-47-148-20"
185,48591,100,19717,68308,21,"3-15-145-13-195-168-11-29-0-109-35-106-124-62-83-18-55-34-152-140-183-95-86-185-148-47-94-179-166-194-88-176-180-113-114-137-127-165-89-103-163-187-146-153-81-77-141-36-61-21-82-8-104-144-160-33-138-139-134-74-118-121-112-25-177-5-78-175-45-80-190-136-73-164-31-54-193-117-198-156-1-16-27-38-102-63-96-32-135-122-90-191-51-120-71-147-6-188-169-70"
186,46868,100,21551,68419,19,"62-124-106-143-34-152-155-3-70-145-168-195-13-132-169-188-6-147-134-74-118-98-51-191-90-122-135-63-38-27-1-198-117-193-190-80-136-73-31-54-112-121-25-182-138-139-11-33-160-29-0-109-35-111-144-104-8-82-21-177-5-78-175-36-61-141-77-153-187-165-127-89-163-103-114-137-75-113-180-176-194-166-86-185-95-130-99-179-66-94-47-148-60-23-20-28-140-183-55-18"
187,49735,100,23084,72819,17,"81-153-159-143-124-106-176-113-103-163-89-165-127-114-194-166-86-95-185-179-66-94-47-148-60-20-28-140-183-53-152-170-34-55-18-62-35-109-0-29-189-155-145-15-3-70-188-169-195-168-33-138-11-139-134-147-191-90-125-51-118-25-123-5-45-136-73-112-121-131-135-122-40-63-38-27-1-42-156-198-117-193-31-54-164-190-80-162-142-175-78-177-36-61-141-97-77-82-8-111"
188,47972,100,20751,68723,21,"185-86-166-194-88-176-113-114-137-127-165-89-103-26-163-153-81-77-111-144-56-104-8-21-61-36-177-5-78-175-142-45-80-190-73-54-31-193-117-198-156-42-1-27-38-135-63-40-107-133-10-178-147-191-90-122-131-121-51-118-182-138-33-160-29-0-35-109-168-145-15-70-3-189-155-152-170-34-143-106-124-128-62-18-55-183-140-149-28-59-20-60-148-47-94-66-179-99-130-95"
189,47530,100,21905,69435,21,"134-139-11-138-33-160-29-0-109-35-37-111-144-104-8-82-21-61-177-5-45-190-80-162-175-142-78-36-141-97-77-81-153-143-124-106-176-180-113-103-163-89-127-137-114-194-166-86-181-95-130-185-179-94-47-148-60-20-28-149-4-140-183-62-18-55-34-152-155-3-70-15-145-168-195-13-132-169-188-6-147-133-122-90-191-125-131-135-63-38-27-1-198-117-193-31-54-73-121-51"
190,47813,100,20183,67996,19,"164-31-54-193-117-198-156-1-112-121-131-122-135-102-63-40-107-133-90-191-51-98-118-134-139-11-168-195-13-132-169-6-188-70-3-15-145-189-155-152-34-18-62-83-55-183-140-4-149-28-20-148-94-179-185-95-86-166-194-114-137-127-165-89-163-103-113-176-124-106-159-143-35-109-0-29-160-33-138-104-8-21-82-77-141-91-61-36-177-5-78-175-142-45-162-46-80-190-136-73"
191,46027,100,19940,65967,19,"134-6-188-169-132-13-70-3-15-145-195-168-139-11-138-33-160-29-109-35-0-144-104-8-111-81-153-159-143-106-124-62-18-55-34-152-183-140-28-20-148-47-94-179-185-86-166-194-176-180-113-103-114-137-127-89-163-165-187-97-77-141-91-36-61-21-177-5-78-175-142-45-80-190-136-73-54-31-193-117-198-156-1-112-121-131-135-102-63-100-40-107-10-133-122-90-191-51-118-74"
192,50535,100,21545,72080,20,"148-20-60-47-94-66-179-172-52-166-86-128-83-18-62-124-143-159-106-176-180-194-113-103-163-187-146-153-81-77-141-82-21-91-61-36-177-5-78-175-45-80-190-193-31-54-117-198-156-42-1-16-27-38-102-63-135-122-133-10-147-71-120-191-90-125-131-121-51-98-118-182-138-33-104-8-144-160-0-35-109-29-168-195-145-70-3-155-152-170-34-55-140-149-28-183-95-130-185-99"
193,48562,100,21596,70158,19,"127-89-163-103-114-113-180-176-194-166-86-185-130-95-124-106-143-62-18-55-183-140-94-47-148-20-28-149-152-184-155-3-70-15-145-13-195-168-169-188-6-147-71-67-120-191-90-122-133-107-40-63-135-1-156-198-117-193-190-80-136-73-31-54-131-125-51-98-118-121-158-25-182-138-104-144-33-160-29-0-109-35-111-8-82-21-177-5-142-175-78-36-61-141-97-77-81-153-187-165"
194,47418,100,21084,68502,21,"66-172-179-185-22-99-130-95-86-166-194-176-180-113-103-127-89-163-106-124-62-18-55-34-35-109-0-29-160-33-11-139-182-138-104-144-8-82-77-141-91-61-36-78-175-162-80-190-45-5-177-21-157-25-51-191-90-121-73-54-31-193-117-198-156-1-38-135-63-100-40-107-17-72-122-133-10-147-134-6-188-169-132-168-195-145-15-70-3-155-152-183-140-149-28-20-60-148-47-94"
195,49620,100,21686,71306,18,"183-140-55-18-62-128-124-106-143-35-0-109-189-155-3-70-15-145-132-169-195-168-139-11-49-29-160-33-144-111-82-8-104-138-182-25-121-112-73-164-31-54-117-198-156-197-1-131-90-191-125-51-147-10-133-107-40-100-122-135-63-102-38-27-16-42-30-193-136-190-80-45-142-175-78-5-177-36-61-91-141-77-153-163-89-127-103-113-176-194-166-86-179-94-47-148-20-99-185-95"
196,48272,100,21223,69495,20,"117-54-73-31-193-190-80-175-78-5-177-36-141-77-81-111-8-104-138-33-160-29-0-109-35-18-83-62-128-124-106-153-163-103-89-127-137-114-113-180-176-88-194-166-86-95-130-185-94-47-148-60-20-28-149-140-183-174-55-34-152-155-3-70-15-145-11-139-168-195-132-169-188-6-150-147-134-118-51-191-90-121-131-135-32-122-133-10-72-107-40-100-63-102-38-27-16-1-156-198"
197,48559,100,21601,70160,21,"5-177-25-182-138-33-160-144-104-8-82-141-77-81-153-187-163-103-89-127-137-114-26-113-176-194-166-86-185-179-66-94-47-60-148-130-95-183-20-28-149-140-152-170-34-174-55-18-83-62-124-106-159-143-35-109-0-12-29-11-139-74-134-43-168-195-13-145-15-3-70-132-169-188-6-147-191-90-51-121-112-19-131-135-32-122-133-107-40-63-1-156-198-117-54-31-193-190-80-175"
198,49318,100,22015,71333,20,"113-176-194-166-86-185-47-148-60-20-28-140-183-55-18-62-128-124-106-143-34-152-184-155-3-145-33-138-11-168-195-132-169-188-6-147-10-133-107-40-63-135-122-90-191-125-51-98-118-74-25-121-131-38-27-16-1-198-117-193-31-54-73-136-190-80-162-45-142-175-78-5-177-8-104-56-144-160-29-0-109-35-37-111-81-97-77-82-21-36-61-79-91-141-187-153-163-89-127-103"
199,46839,100,21757,68596,21,"195-168-145-15-70-3-155-152-34-143-106-124-62-18-55-183-140-28-20-60-148-47-154-94-66-179-185-99-130-95-86-166-194-176-113-103-114-127-89-163-187-153-77-141-91-61-36-78-175-45-80-190-193-198-1-117-54-31-73-5-177-21-82-8-104-111-35-109-0-29-160-33-11-138-182-25-121-131-135-32-102-63-100-40-107-10-133-122-90-191-125-51-71-147-134-6-188-169-132-13"
200,49325,100,22002,71327,19,"137-127-165-89-103-26-163-187-146-153-77-82-8-21-61-36-177-5-142-78-175-80-190-136-73-164-31-54-193-117-198-1-16-27-38-135-32-102-63-100-40-107-17-72-133-10-147-51-90-122-131-121-112-25-182-138-33-11-139-188-169-132-70-3-145-13-195-168-29-0-35-109-152-149-28-20-60-148-47-94-66-179-185-166-86-95-130-99-140-183-18-62-124-143-159-106-176-194-113-114"
