SolutionID,TotalCost,NumNodes,TotalDistance,ObjectiveFunction,TotalRunningTime,Cycle
1,97051,100,46141,143192,85,"75-120-44-25-145-78-92-129-137-0-68-198-115-5-63-152-57-55-49-186-23-130-101-86-53-41-193-159-139-46-60-51-80-94-97-1-2-52-178-106-185-165-39-119-40-196-81-90-27-7-164-21-31-113-175-171-16-70-127-96-42-48-54-10-177-148-62-9-176-184-160-34-181-14-144-89-183-143-117-140-93-69-108-18-146-22-43-162-154-180-79-133-151-72-59-116-65-24-123-135"
2,95549,100,44455,140004,29,"80-94-19-63-79-151-72-59-115-46-137-148-178-106-3-155-144-15-116-184-4-112-70-53-97-2-129-78-145-57-49-62-9-111-152-1-101-86-154-135-123-65-105-43-34-160-48-54-177-75-171-16-25-44-120-82-92-165-7-164-95-31-175-113-56-90-27-133-162-180-55-52-185-196-81-40-14-186-23-108-18-159-22-146-181-42-139-89-183-143-68-41-193-93-140-117-0-109-51-176"
3,102073,100,46687,148760,23,"63-79-12-39-164-27-90-81-135-127-123-112-35-193-41-18-108-117-143-0-87-145-31-56-113-44-75-162-47-65-116-59-109-118-115-46-51-80-176-148-9-62-33-111-94-19-97-101-1-86-158-53-55-185-165-40-92-129-57-52-106-178-180-154-89-183-83-114-7-21-138-133-151-105-43-42-184-177-54-160-34-22-159-139-152-125-49-14-144-186-23-137-120-25-16-171-175-78-82-2"
4,97240,100,45350,142590,22,"41-159-193-42-24-112-4-123-127-70-75-44-16-171-175-113-31-196-81-90-107-27-40-185-145-78-92-106-178-3-152-1-97-94-12-23-186-59-116-65-131-184-160-43-77-176-167-165-95-164-7-25-120-2-129-57-55-52-148-137-109-115-191-139-46-183-89-144-21-14-49-102-177-54-34-18-108-79-63-101-86-53-154-180-136-121-9-62-15-143-0-117-22-146-51-80-133-135-162-151"
5,106427,100,52207,158634,18,"15-62-9-102-74-2-179-196-81-40-172-53-154-70-48-54-34-22-18-159-193-160-192-178-106-51-176-137-23-186-16-171-175-113-31-78-145-185-14-117-93-140-46-129-92-57-55-52-89-0-143-183-144-49-152-1-120-25-44-75-63-79-80-33-148-111-124-115-139-41-59-151-162-65-116-194-135-90-27-165-130-94-19-97-101-86-158-180-133-5-42-123-127-112-4-177-84-35-184-43"
6,105191,100,51869,157060,48,"171-175-13-179-172-167-139-193-41-5-42-105-116-133-79-52-40-185-128-148-48-30-54-177-4-112-123-49-14-178-106-56-113-16-75-176-46-0-23-62-9-80-151-160-34-181-159-115-94-152-87-55-57-92-129-25-44-120-2-97-1-101-86-53-180-154-35-11-184-43-127-70-135-93-117-143-183-89-137-51-118-59-65-149-162-63-81-90-165-144-69-108-18-22-146-196-31-38-145-78"
7,100641,100,47378,148019,23,"9-144-14-3-106-52-75-101-86-100-53-133-72-41-159-22-146-181-42-162-154-180-63-122-79-151-116-105-65-121-189-97-1-2-129-92-57-145-196-55-28-160-34-43-172-178-49-15-137-176-94-152-120-25-44-78-16-175-171-113-31-81-119-40-185-69-108-18-193-191-115-123-127-70-135-23-186-183-89-0-143-117-139-46-59-51-141-165-90-27-164-80-45-184-54-177-4-112-148-62"
8,99569,100,46470,146039,21,"133-4-84-48-54-177-10-196-81-90-27-176-116-65-180-53-86-75-129-92-185-8-165-40-145-78-44-120-2-1-152-97-101-154-184-160-34-42-5-118-137-183-143-93-140-163-69-18-108-15-144-14-106-178-52-49-9-62-80-156-112-127-70-135-194-123-43-149-151-162-59-115-139-41-193-22-159-198-55-57-31-85-56-175-113-171-16-46-68-117-170-0-60-51-79-63-94-12-148-124"
9,97650,100,42857,140507,20,"86-75-78-38-145-91-185-106-138-178-52-57-55-92-129-44-120-2-101-135-184-54-160-43-9-62-148-80-151-162-45-133-154-180-53-136-23-186-31-113-56-175-171-16-65-47-105-42-181-34-22-146-41-149-123-127-194-72-176-144-14-114-89-183-143-117-93-68-46-139-110-193-159-18-69-108-0-137-130-94-122-79-63-1-97-152-196-81-40-90-165-49-51-59-115-197-116-35-112-70"
10,97613,100,44112,141725,19,"115-160-54-10-177-4-127-121-97-1-26-180-135-154-53-101-2-57-55-49-23-137-66-149-84-112-162-9-62-148-12-167-92-196-40-90-27-81-188-25-75-70-194-123-184-34-146-22-159-109-176-52-185-8-106-3-178-94-122-59-41-193-43-42-116-65-86-120-44-16-171-113-175-56-31-38-78-145-129-152-63-79-133-151-118-51-80-130-165-95-14-144-183-0-143-117-108-18-139-46"
11,103742,100,47844,151586,20,"180-75-25-31-157-90-27-165-14-137-139-193-18-108-21-164-144-9-123-112-4-151-89-183-143-117-0-2-120-78-145-49-62-23-186-196-17-81-40-119-185-106-3-178-94-122-63-189-152-1-97-99-46-115-197-116-65-47-129-92-57-55-52-87-101-86-53-121-100-44-16-171-175-113-41-159-22-34-160-184-43-42-118-59-51-109-66-80-176-37-148-12-79-133-162-127-70-135-154-173"
12,101051,100,49823,150874,22,"44-120-167-178-106-55-57-179-52-49-62-9-64-15-152-101-75-86-24-42-43-80-176-51-115-181-34-22-18-159-193-41-139-46-137-14-164-7-21-144-186-89-183-143-0-160-177-10-190-149-162-151-59-65-116-35-84-4-112-172-129-2-53-180-154-135-70-127-123-173-92-145-31-175-113-78-94-79-63-97-1-26-133-184-54-48-148-27-90-81-40-165-185-23-117-140-93-111-16-171"
13,100748,100,43656,144404,20,"41-193-159-22-18-2-120-25-44-148-186-23-0-46-60-51-79-121-97-152-185-40-27-90-165-8-7-164-21-94-63-180-173-133-151-72-176-137-62-9-33-172-38-31-56-113-92-129-57-55-52-118-59-65-116-43-77-42-34-160-54-184-177-196-81-98-144-61-15-89-183-143-117-139-115-149-161-162-127-123-135-154-53-26-1-86-101-75-16-175-171-78-145-179-178-106-14-49-130-80"
14,93233,100,40253,133486,18,"44-120-2-129-145-31-38-78-135-70-127-123-193-41-159-69-18-108-182-53-86-75-16-171-175-113-196-52-55-106-178-3-14-144-114-89-183-186-9-62-49-165-27-90-81-40-185-148-48-160-42-96-59-118-51-151-133-154-180-158-101-1-97-87-92-91-179-57-94-63-79-80-176-23-137-76-0-22-34-54-177-115-46-139-140-93-117-143-170-149-112-4-184-43-116-65-162-189-152-25"
15,107194,100,54329,161523,21,"4-135-180-52-185-8-40-196-169-55-59-118-148-37-137-115-184-54-177-53-92-129-2-120-44-25-57-49-23-46-41-159-193-22-34-160-181-42-161-56-31-157-90-27-164-7-165-145-78-187-81-93-36-140-68-26-86-101-97-1-152-89-183-117-108-18-69-139-133-75-16-171-175-113-154-70-127-43-116-65-45-162-151-51-141-143-0-176-80-79-63-94-62-9-144-14-178-106-123-112"
16,109466,100,55307,164773,16,"186-89-183-143-117-139-5-42-43-123-127-149-47-65-162-182-136-185-40-112-4-24-9-62-179-145-78-2-116-197-59-72-26-97-165-138-49-192-34-22-193-41-115-109-51-176-23-137-124-94-80-151-45-133-189-152-57-92-129-1-121-158-53-63-122-79-135-70-177-54-84-86-75-101-0-108-18-120-44-171-16-175-113-31-81-90-46-181-160-184-154-180-148-167-52-55-106-178-14-144"
17,103157,100,48473,151630,16,"108-159-193-42-105-43-77-25-44-78-145-14-144-137-46-198-23-186-148-94-176-141-66-80-79-21-164-165-52-55-91-196-167-128-139-41-181-177-10-184-56-31-50-113-175-171-16-0-93-140-117-170-143-153-183-89-178-106-185-40-90-81-92-162-65-116-115-59-51-151-133-63-121-53-180-127-123-135-154-86-101-75-120-57-49-102-62-9-152-2-1-97-182-30-54-48-160-34-22-18"
18,98795,100,46184,144979,18,"65-116-43-5-46-183-89-57-25-44-120-135-123-35-4-112-127-78-31-145-106-178-138-165-90-55-2-75-86-53-154-180-94-148-119-40-185-52-184-48-54-177-10-190-84-149-131-162-133-151-59-193-159-22-18-108-140-93-117-176-63-182-99-189-97-101-1-87-92-129-152-124-130-137-23-186-9-62-49-14-144-143-0-139-41-115-109-51-80-79-122-42-181-34-160-70-16-171-175-113"
19,99955,100,46045,146000,17,"196-81-40-185-49-62-9-167-128-125-152-52-165-27-90-21-14-122-79-63-94-148-144-73-80-133-154-180-53-101-86-89-183-143-117-93-46-162-16-31-145-179-57-92-120-2-99-151-109-51-176-19-106-3-178-4-177-54-34-160-42-43-116-65-47-131-135-70-127-123-24-149-59-0-137-55-56-113-175-171-75-112-184-146-22-159-18-108-69-193-41-139-198-115-26-97-1-44-25-78"
20,98657,100,44360,143017,17,"126-123-162-133-53-86-101-1-152-49-14-165-40-185-55-57-154-70-4-190-177-10-151-178-106-52-113-175-171-16-44-75-51-59-65-116-43-118-0-117-143-189-100-121-99-97-2-120-78-31-145-92-160-181-42-144-102-167-94-63-180-173-35-184-48-54-127-135-6-79-80-176-137-183-89-23-186-62-9-148-46-159-199-18-69-108-163-139-115-96-41-193-68-93-140-22-146-34-84-112"
21,92933,100,41587,134520,18,"86-101-44-25-145-78-120-2-80-139-193-22-159-140-93-108-18-69-117-143-23-57-92-129-1-97-136-121-94-52-55-74-152-53-158-135-70-112-4-54-48-160-42-65-161-127-123-28-184-43-116-115-46-0-183-89-9-62-49-56-113-175-171-148-186-137-51-131-190-10-177-34-181-41-151-133-79-63-180-154-162-59-118-109-176-144-165-90-81-40-185-138-14-106-178-196-157-31-16-75"
22,95158,100,43545,138703,18,"159-193-68-0-153-143-183-89-137-129-82-2-1-97-53-154-135-70-117-140-93-42-177-10-180-152-57-111-55-52-92-78-145-40-185-178-49-114-186-23-148-16-171-113-175-31-14-144-62-94-136-63-79-122-120-25-44-75-86-101-100-133-151-51-162-161-59-118-176-80-167-106-165-90-164-21-108-18-184-84-4-112-123-131-47-65-43-116-115-46-139-191-41-30-54-48-160-34-22-146"
23,97417,100,43738,141155,17,"175-113-185-40-80-176-137-0-143-60-51-121-100-26-86-53-154-135-112-4-184-77-116-65-122-63-79-133-151-162-161-127-123-59-109-15-186-23-183-89-42-48-54-160-192-43-180-97-2-92-55-57-115-96-41-193-181-34-30-177-70-75-56-31-78-145-150-101-1-152-148-62-9-49-14-165-90-27-144-46-139-159-22-18-69-108-140-93-117-94-124-52-106-178-167-129-120-44-16-171"
24,98321,100,47054,145375,17,"98-81-90-144-186-23-137-176-12-55-52-106-185-40-31-175-113-56-165-14-138-178-97-1-2-129-49-62-18-22-159-25-16-171-44-101-51-118-59-197-148-9-15-46-115-116-194-154-180-79-133-151-162-139-41-193-181-34-48-54-160-43-42-184-177-4-112-70-158-26-100-53-135-127-123-47-65-80-63-86-75-120-78-145-92-57-167-152-189-94-89-183-143-0-117-93-140-68-82-196"
25,93181,100,40604,133785,18,"111-57-92-145-82-129-80-59-116-115-139-46-60-137-23-89-183-0-68-96-5-65-162-121-26-97-154-135-112-4-190-10-177-54-160-42-43-123-1-52-55-178-106-165-40-185-172-94-12-15-186-176-51-118-108-18-93-117-143-138-90-81-196-56-113-175-171-44-75-70-127-184-34-22-193-41-151-133-79-63-180-158-53-86-101-120-78-31-50-16-25-2-152-148-62-9-144-14-49-167"
26,94609,100,40223,134832,17,"12-122-79-118-0-143-183-89-23-41-193-159-22-146-195-184-84-112-123-9-62-111-53-154-180-6-135-162-51-46-139-115-59-72-151-133-152-129-57-92-120-44-2-87-94-42-160-43-105-116-65-131-128-106-178-155-144-117-108-18-34-54-177-127-70-86-75-101-1-97-26-63-80-176-137-186-73-132-21-164-7-165-40-90-81-196-113-175-171-16-78-31-145-55-52-185-138-14-49-148"
27,95321,100,42503,137824,16,"162-45-51-109-80-52-185-138-144-183-143-117-0-68-46-139-5-42-43-166-160-159-108-18-22-146-34-54-184-133-79-63-122-124-94-196-81-90-65-116-149-123-127-70-154-180-53-173-135-194-112-4-190-10-177-40-165-21-14-152-1-97-2-120-25-78-145-101-86-75-44-16-171-113-175-56-31-85-157-57-55-106-3-178-49-23-137-176-148-37-62-9-129-92-26-151-59-115-193-41"
28,98100,100,42221,140321,17,"2-129-92-1-100-53-154-135-162-0-143-183-89-186-23-62-9-144-49-148-181-34-22-159-46-57-179-145-78-25-120-97-63-79-80-51-59-65-116-43-42-160-54-184-77-75-175-113-56-52-55-31-171-16-44-87-125-152-12-137-69-108-18-139-151-133-173-180-128-3-178-106-40-185-165-90-39-14-70-127-123-112-4-10-177-84-166-5-41-193-115-118-109-176-94-19-26-86-150-101"
29,91879,100,40513,132392,17,"143-183-89-109-59-116-65-115-139-191-68-46-118-151-97-1-41-159-193-0-117-93-108-18-22-146-34-54-177-131-23-186-9-62-102-49-148-137-176-122-152-2-55-52-14-7-164-21-144-130-94-136-158-154-180-133-162-112-4-123-63-178-106-31-113-175-171-16-44-25-129-57-92-145-196-81-90-27-165-185-40-169-78-120-75-101-86-53-43-5-42-160-184-127-70-135-79-80-51-60"
30,102460,100,52166,154626,17,"14-144-22-146-181-34-160-127-123-162-133-80-9-62-65-116-105-43-193-159-69-18-108-183-89-23-137-176-51-118-115-59-180-154-53-26-97-189-124-94-178-49-148-12-0-117-143-186-185-40-92-82-1-63-96-42-95-21-7-164-27-175-171-16-184-48-30-54-177-112-70-135-152-165-90-81-113-56-31-78-145-57-55-172-79-151-46-68-139-41-120-44-25-75-86-101-2-129-52-106"
31,101117,100,45061,146178,15,"55-80-151-176-49-3-178-106-57-125-152-154-180-75-16-171-175-90-27-164-21-144-62-9-12-94-63-182-53-97-2-129-25-44-120-1-101-86-70-135-127-123-185-40-119-78-145-92-33-148-137-51-139-159-193-96-41-5-42-181-160-34-54-177-10-184-77-116-197-115-46-140-93-117-143-0-59-162-133-79-85-113-56-13-31-73-183-89-23-186-14-138-39-165-32-65-43-22-18-52"
32,96689,100,44680,141369,19,"154-173-162-65-47-116-43-42-41-139-137-78-56-113-31-145-52-106-55-57-129-82-120-2-1-97-189-94-148-9-144-14-165-40-185-91-92-63-79-133-135-127-123-177-54-34-22-146-70-75-44-196-81-90-27-164-183-143-153-89-186-175-171-16-25-12-176-115-181-160-184-59-151-51-0-117-93-140-108-18-159-193-121-100-26-182-80-198-46-23-62-102-49-178-152-101-86-53-136-180"
33,99555,100,47465,147020,16,"114-15-62-145-78-92-9-137-46-139-191-115-59-135-154-180-133-151-116-41-193-51-176-113-175-171-16-44-120-123-112-156-127-70-52-106-55-57-129-2-49-144-102-152-1-101-75-86-97-148-33-12-122-80-79-162-184-43-65-185-196-81-31-25-158-53-136-63-94-14-7-90-27-165-40-119-8-3-178-4-177-54-160-42-0-117-140-93-159-34-181-146-22-18-108-143-183-89-23-186"
34,102948,100,52740,155688,19,"143-117-93-18-108-22-34-181-42-167-148-80-176-79-133-63-182-97-55-40-119-144-89-183-0-110-159-41-193-139-137-9-62-127-123-162-51-23-186-114-15-1-101-70-54-48-160-43-131-92-145-78-38-31-113-171-175-16-25-44-120-2-75-86-112-4-177-184-35-129-57-185-165-27-90-81-196-135-77-116-65-151-94-152-52-14-21-164-7-95-53-180-154-59-115-198-46-106-178-49"
35,91885,100,39101,130986,15,"171-16-70-4-112-127-135-133-176-183-143-0-117-68-198-46-139-41-193-159-22-34-42-59-51-137-186-83-89-23-180-154-47-65-123-194-162-116-43-160-54-177-10-184-35-53-26-97-189-19-152-129-92-57-106-14-21-7-164-27-90-40-119-185-145-31-113-81-165-144-148-12-94-99-182-63-79-93-108-18-115-72-151-80-9-62-102-49-178-52-78-44-25-120-75-86-101-1-2-175"
36,98167,100,44309,142476,17,"31-56-113-97-1-120-44-25-92-129-57-128-37-186-23-15-62-9-144-64-183-89-143-0-117-108-18-43-42-22-159-193-41-181-34-160-116-52-55-152-125-2-16-171-175-81-187-185-177-10-54-48-151-133-79-63-180-154-135-70-127-123-162-65-184-4-84-112-80-94-145-196-78-75-150-86-101-53-189-19-33-49-14-178-106-40-90-27-7-164-165-138-148-176-51-59-115-139-46-137"
37,106782,100,51873,158655,15,"127-123-184-160-34-62-155-14-178-92-129-0-117-143-183-152-2-78-171-16-44-25-120-75-101-1-23-89-186-9-148-130-94-124-144-21-164-27-90-81-196-176-115-41-139-46-137-49-106-91-56-113-175-31-145-193-159-22-146-18-108-69-121-86-53-158-180-133-151-45-105-43-48-54-177-185-40-165-39-63-162-161-189-19-97-57-52-55-172-96-42-116-65-59-51-80-79-154-135-70"
38,103174,100,47610,150784,15,"180-123-127-70-6-135-154-144-73-21-164-7-165-38-31-85-56-75-101-1-111-167-148-176-51-80-94-152-25-44-16-171-175-113-86-65-43-181-22-18-159-193-59-72-109-102-185-40-174-196-81-17-91-189-63-79-133-151-162-149-77-184-54-177-30-34-160-53-97-2-120-129-90-27-138-14-118-115-41-42-116-49-178-106-145-78-92-62-9-186-89-183-143-0-46-139-137-52-55-57"
39,100360,100,47715,148075,14,"144-62-114-143-108-18-159-22-193-65-116-149-172-55-9-89-183-0-141-59-43-160-48-184-123-127-135-70-56-113-31-106-32-178-52-57-74-94-12-176-51-118-80-2-120-25-44-63-79-133-162-151-137-23-186-148-152-1-101-86-75-16-171-175-53-180-154-136-97-129-92-145-7-164-21-14-49-115-42-34-181-41-139-140-93-117-46-54-177-112-26-78-81-90-27-165-8-40-185-155"
40,102658,100,47428,150086,14,"148-141-115-46-129-57-33-9-62-144-14-78-16-44-63-151-59-197-41-191-139-52-55-152-97-53-180-154-6-173-135-4-112-84-184-43-149-162-182-31-113-175-171-42-181-146-22-93-140-108-18-69-163-123-127-70-94-165-27-90-81-196-145-120-75-86-101-1-2-92-185-40-106-178-49-186-89-183-23-137-0-153-143-117-68-193-159-34-160-54-177-51-176-80-79-133-45-65-116-37"
41,100397,100,43086,143483,16,"70-127-123-133-130-148-9-128-92-129-82-2-152-74-1-120-113-175-84-54-48-34-160-43-42-22-159-193-41-89-144-14-73-183-143-0-117-18-108-139-46-137-178-106-172-158-180-136-53-94-23-186-62-102-49-145-78-31-81-90-165-185-40-52-55-57-167-176-51-59-72-65-116-149-184-177-10-4-112-16-171-44-75-86-101-97-19-99-63-79-80-141-198-115-60-151-45-162-154-135"
42,100389,100,48366,148755,14,"106-178-49-102-114-183-89-23-186-125-152-97-1-121-139-110-198-62-14-138-9-115-41-193-137-144-21-7-164-27-90-81-40-185-165-52-2-63-79-80-94-128-57-92-145-78-55-15-143-108-18-22-159-42-65-47-59-151-180-154-70-135-127-123-46-117-0-133-136-86-101-120-25-44-75-112-4-84-190-10-177-54-48-38-31-113-171-175-16-53-162-184-160-34-43-116-118-51-176-148"
43,100014,100,44913,144927,18,"118-151-53-100-26-121-63-79-122-94-37-148-176-65-43-116-109-51-40-119-165-90-81-196-145-92-111-46-115-5-42-181-160-184-123-161-162-133-19-97-1-101-70-127-112-4-10-177-54-34-117-143-0-137-120-171-175-16-44-25-113-31-38-78-62-9-89-183-23-186-144-14-49-3-106-178-185-129-2-75-86-180-41-193-22-18-108-52-55-57-152-80-191-139-135-6-154-45-59-197"
44,91682,100,40274,131956,16,"9-62-114-144-102-49-14-165-27-90-92-129-44-25-120-75-189-97-152-3-178-106-179-78-145-57-148-137-176-65-116-181-146-22-18-80-79-63-94-124-185-40-81-17-31-56-196-186-23-89-183-143-153-0-46-115-118-59-151-162-131-105-43-42-160-177-10-190-16-171-175-113-2-87-1-101-86-53-154-180-135-70-127-117-93-139-41-193-159-34-48-54-184-84-4-112-123-133-52-55"
45,100284,100,41576,141860,16,"69-68-176-80-122-79-63-154-180-161-123-112-84-35-51-141-110-191-139-118-136-53-78-145-52-106-178-152-86-75-120-25-44-16-171-175-113-31-65-166-11-149-162-133-151-59-116-96-193-41-181-48-160-42-43-105-115-46-0-183-89-23-186-9-62-94-99-97-1-101-2-92-185-40-165-137-140-108-93-117-143-61-144-14-49-148-12-30-54-177-4-29-127-70-135-184-34-22-159-18"
46,97140,100,44347,141487,18,"79-122-9-62-178-106-185-40-90-81-196-145-78-184-177-10-54-34-160-43-77-65-151-133-63-94-55-52-165-164-21-144-155-137-59-42-181-159-193-41-139-68-141-12-97-101-1-3-138-14-102-49-57-92-129-2-135-123-131-162-180-53-100-152-33-148-186-23-89-183-143-0-46-51-80-176-117-93-22-146-31-113-175-171-16-44-120-75-86-121-136-154-70-127-116-197-115-18-69-108"
47,101810,100,48480,150290,15,"112-4-16-175-171-113-31-62-9-37-129-92-57-55-52-148-22-159-181-184-162-180-154-115-193-41-139-198-46-0-117-93-140-18-69-191-94-1-145-78-25-44-120-2-152-14-144-163-108-143-183-89-23-186-49-106-178-5-42-176-137-80-133-151-149-123-135-26-97-19-63-79-136-86-75-185-40-90-27-165-101-53-158-70-127-43-65-116-59-51-141-60-103-146-34-160-48-30-54-177"
48,92060,100,41311,133371,16,"179-178-106-185-119-40-90-165-164-21-14-144-186-153-143-117-0-176-80-79-63-180-154-53-101-1-97-26-100-86-75-120-44-25-78-145-31-113-81-196-49-46-108-69-18-22-54-177-184-9-62-93-140-139-115-41-193-159-181-34-160-65-151-51-109-118-5-192-42-43-116-59-183-89-23-137-70-135-55-52-57-92-129-19-127-123-156-29-112-4-84-162-133-94-148-152-2-16-175-171"
49,92745,100,39768,132513,16,"86-189-51-118-59-72-151-80-94-124-63-162-166-190-10-177-184-28-43-42-96-115-109-176-148-52-55-196-185-106-178-9-62-186-23-89-183-143-117-41-181-48-160-35-84-4-112-123-133-79-180-154-53-16-171-175-113-31-78-145-110-139-46-137-165-40-14-144-49-57-92-129-44-120-0-93-140-108-18-69-199-193-116-65-159-22-146-34-54-30-127-135-70-19-152-2-97-1-101-75"
50,93172,100,40555,133727,16,"116-166-43-105-65-86-16-171-78-145-179-185-106-178-52-55-92-57-53-135-127-123-162-136-152-129-2-75-150-101-1-97-100-115-41-193-159-22-146-181-42-197-59-51-176-124-94-63-122-79-133-180-154-158-137-186-9-62-148-80-151-184-35-112-4-177-54-160-34-139-46-68-0-153-183-143-117-93-18-108-21-164-90-40-31-56-113-175-25-44-120-167-138-165-8-14-49-144-89-23"
51,89161,100,35738,124899,17,"143-117-0-46-139-193-41-115-59-162-123-43-181-34-42-116-65-151-133-79-63-127-11-184-35-160-54-177-10-4-112-70-44-16-171-175-113-56-31-78-145-129-2-1-152-125-52-165-90-164-21-14-119-40-185-91-25-120-82-92-57-55-106-178-49-155-144-89-183-23-137-68-18-22-146-159-51-176-80-122-121-99-19-97-26-101-75-86-154-135-180-53-94-12-148-9-62-15-108-69"
52,103737,100,48619,152356,16,"115-124-111-106-119-90-27-165-3-178-49-9-148-133-127-123-135-154-53-152-185-40-174-81-31-56-75-101-86-180-177-184-28-166-65-59-118-23-137-151-161-162-45-72-4-112-84-35-0-143-117-108-18-22-193-159-42-43-116-109-62-144-14-164-21-186-183-89-160-34-54-16-175-113-171-44-120-92-55-57-129-2-97-1-63-79-176-80-51-60-46-141-94-78-145-196-52-167-139-41"
53,98136,100,47636,145772,16,"8-46-193-41-159-96-72-129-92-106-178-164-7-53-154-180-135-127-123-65-116-43-42-181-54-10-177-4-70-57-55-52-133-151-162-112-84-184-160-34-146-22-68-117-143-183-9-62-137-109-51-176-167-111-94-63-79-144-14-49-179-175-171-78-145-120-2-101-1-97-152-148-186-23-89-21-27-90-31-85-56-113-16-25-44-75-86-26-189-80-0-93-18-108-139-115-59-185-40-165"
54,102679,100,48073,150752,17,"182-53-158-180-133-162-4-112-135-70-177-54-48-184-151-79-63-136-99-97-129-92-57-55-12-176-51-118-59-123-127-10-190-65-141-137-0-139-41-193-18-117-143-183-89-78-25-44-120-75-101-1-62-9-61-148-124-145-31-16-171-175-113-81-40-185-152-74-94-80-46-60-186-144-164-27-90-165-14-43-42-181-159-22-146-34-160-154-86-2-52-178-106-49-72-116-115-23-15-130"
55,98074,100,44989,143063,16,"159-195-181-79-63-19-52-55-57-53-180-154-70-135-151-0-93-140-20-22-146-34-54-177-10-190-48-160-18-108-183-89-9-62-33-152-97-100-121-80-46-115-176-130-129-92-1-101-86-75-2-120-44-78-145-182-41-193-139-191-68-117-143-66-51-59-116-184-84-4-112-149-123-127-47-65-178-106-165-14-49-102-144-186-23-137-148-16-171-113-175-31-90-40-185-94-133-162-43-42"
56,96443,100,45799,142242,17,"144-62-37-148-12-63-79-42-34-160-43-133-136-121-97-101-75-120-25-145-78-31-56-175-113-171-16-44-86-116-65-151-59-115-139-46-21-164-165-178-106-146-195-159-193-41-162-135-70-127-123-112-4-190-10-177-54-184-154-53-26-100-180-173-22-18-183-89-23-137-51-80-176-186-9-3-49-143-117-0-122-94-129-57-55-52-40-185-119-27-90-81-179-196-92-2-1-152-138-14"
57,91140,100,38475,129615,18,"173-28-160-48-54-177-10-190-184-46-0-143-117-159-22-18-108-15-62-178-185-40-129-2-152-94-80-148-37-82-25-44-120-101-1-97-167-49-14-165-90-81-196-92-57-55-52-106-145-78-31-56-175-113-171-16-75-123-24-65-116-105-47-77-127-70-135-154-180-79-137-23-183-89-186-114-73-144-155-9-176-51-84-4-112-162-151-59-115-139-193-41-34-181-42-43-133-63-86-53"
58,91940,100,39473,131413,16,"30-48-54-160-34-181-41-42-105-65-162-123-127-135-53-26-97-101-86-182-59-193-159-146-22-18-108-78-175-113-56-31-145-92-129-63-79-80-176-66-51-133-180-154-151-72-115-191-139-68-117-143-0-46-84-4-112-156-70-75-120-44-25-16-171-196-81-90-148-89-183-144-155-14-106-178-9-62-49-165-185-40-1-152-2-57-52-55-94-122-130-186-23-137-116-43-184-190-10-177"
59,99752,100,46334,146086,17,"137-141-109-51-31-56-113-25-44-42-181-5-92-145-78-79-133-162-123-194-106-178-3-32-49-37-148-33-167-2-152-154-135-180-182-63-94-9-62-14-40-165-185-52-55-57-129-120-75-86-158-53-101-1-97-100-112-177-54-34-22-18-108-140-93-117-143-0-59-65-116-127-70-16-175-171-38-186-23-183-89-46-115-139-41-193-159-160-184-35-43-151-176-80-124-196-81-90-39-144"
60,95411,100,43175,138586,16,"149-43-65-116-115-139-46-23-137-176-80-79-63-120-78-56-31-196-165-3-14-49-148-184-160-54-177-10-190-34-181-41-193-51-66-151-133-135-6-180-154-158-53-94-128-167-102-155-144-89-183-143-117-0-172-129-2-101-86-127-112-4-70-75-44-25-16-171-175-113-81-40-185-179-57-52-55-106-178-124-152-97-1-92-145-90-27-59-42-5-159-22-18-108-69-186-62-9-162-123"
61,93841,100,39083,132924,17,"41-193-181-34-48-160-43-137-9-148-124-19-100-53-121-86-1-55-52-106-178-3-49-14-57-92-25-44-78-145-31-56-85-113-175-171-16-196-81-90-27-165-94-63-136-189-152-128-8-185-40-180-154-135-127-123-149-159-146-22-18-139-51-176-80-79-133-162-151-61-144-102-62-59-65-105-116-115-46-117-143-0-2-129-120-75-101-97-130-12-23-186-89-183-42-54-177-10-190-184"
62,98621,100,43471,142092,14,"180-154-53-100-1-97-74-152-44-120-25-145-91-81-196-31-56-113-4-112-35-43-42-41-198-46-51-185-40-165-90-27-164-183-117-143-0-122-63-19-57-79-151-116-193-159-18-139-115-59-80-94-124-148-33-16-88-175-171-78-92-52-178-106-182-123-127-70-135-133-176-66-137-23-186-89-83-9-62-102-144-14-49-55-2-101-75-86-28-184-160-48-177-10-54-34-22-146-65-162"
63,95535,100,40005,135540,17,"139-191-193-41-42-86-75-44-25-16-171-175-113-31-120-2-87-129-55-52-14-144-132-183-143-0-153-176-80-94-12-49-3-178-106-185-119-40-165-62-186-89-23-137-51-198-46-93-117-63-121-101-1-196-81-90-164-7-21-9-180-154-135-70-127-123-131-184-54-34-160-43-45-162-65-116-108-18-69-22-146-195-159-133-53-100-97-148-128-57-38-78-145-92-152-79-151-59-197-115"
64,103677,100,52187,155864,15,"56-58-164-7-14-21-144-102-49-94-63-79-151-51-0-143-170-46-60-57-92-44-120-59-118-68-93-117-183-89-23-137-112-4-84-184-166-180-53-86-55-185-165-40-196-81-27-90-70-190-10-177-34-146-22-159-41-115-97-1-101-75-2-52-178-106-148-80-176-9-62-152-154-135-127-126-193-18-108-69-139-175-16-171-133-45-162-123-149-116-65-43-42-160-54-48-145-78-31-113"
65,91817,100,37180,128997,13,"178-138-49-9-160-54-34-146-22-159-193-139-46-140-69-108-18-41-42-181-43-115-197-116-65-131-151-57-92-129-120-44-25-16-88-171-175-113-145-179-52-106-119-40-185-55-2-152-94-122-63-53-86-75-78-13-56-31-196-81-90-165-8-3-14-144-61-62-186-23-148-37-97-1-101-177-184-35-127-70-135-162-133-79-80-176-0-93-117-143-183-89-137-66-51-59-123-24-154-180"
66,104047,100,50873,154920,15,"94-178-3-106-57-92-129-2-99-121-154-135-70-75-44-78-145-90-27-39-63-123-4-112-16-175-171-113-31-117-93-140-139-110-46-51-176-155-144-49-80-72-65-105-43-34-160-133-182-53-180-149-184-54-177-10-190-127-86-101-148-62-9-15-186-114-23-59-116-42-159-22-18-108-55-196-81-40-185-120-1-97-152-52-165-8-14-0-143-183-89-137-151-162-45-41-193-115-118-79"
67,98037,100,45123,143160,16,"31-78-25-30-54-48-184-166-131-122-178-106-121-136-53-180-154-70-135-63-9-148-37-94-100-86-75-120-44-160-34-22-18-108-159-193-41-96-116-65-151-79-133-162-194-123-127-35-43-42-115-144-14-49-62-186-89-183-23-26-97-82-92-129-80-51-59-84-177-10-190-4-112-176-137-143-0-117-93-139-46-185-40-90-165-152-1-101-150-2-57-55-52-91-145-16-171-175-113-56"
68,96494,100,45017,141511,17,"106-52-55-152-2-92-78-145-179-148-89-183-143-94-26-86-53-158-63-79-133-162-84-54-48-34-146-193-41-42-43-166-184-160-181-65-75-44-16-171-25-120-1-80-118-159-22-18-108-140-117-93-0-49-178-57-97-182-123-126-127-70-135-154-180-173-112-4-190-10-177-51-176-137-186-23-62-9-144-14-165-119-56-175-113-101-151-59-116-197-115-139-46-39-90-81-31-196-40-185"
69,101387,100,46435,147822,17,"117-118-115-139-198-60-152-1-101-97-100-121-24-184-54-177-4-112-123-133-79-122-63-80-144-155-89-76-23-55-57-92-120-2-181-159-193-41-46-186-9-62-49-14-138-3-124-94-180-154-135-70-158-52-185-40-90-165-8-183-93-108-18-22-146-34-160-127-75-16-171-175-56-113-31-145-37-148-137-197-116-65-59-176-178-106-78-25-44-86-53-43-42-105-47-162-151-51-0-143"
70,96905,100,44421,141326,17,"63-94-164-21-14-49-133-162-45-123-11-184-42-43-127-135-158-53-86-75-129-57-55-151-65-116-183-89-23-137-51-59-115-46-0-143-117-93-108-18-69-139-80-52-178-106-185-165-40-90-113-175-88-16-25-44-120-92-168-157-81-196-91-145-78-31-56-171-2-152-181-34-160-48-54-84-156-112-4-190-177-10-70-26-101-1-97-41-193-159-22-146-176-62-144-9-148-79-180-154"
71,99846,100,46268,146114,15,"53-154-70-127-112-4-84-43-76-183-89-176-80-75-171-175-113-56-31-16-44-120-186-23-63-180-6-135-194-123-131-149-162-161-190-10-177-184-72-51-59-116-65-115-0-143-117-93-18-22-159-193-41-148-49-178-106-52-55-79-42-160-48-30-54-34-181-9-62-144-14-46-191-139-151-133-2-78-145-185-165-40-90-81-57-92-152-189-124-94-108-69-140-137-111-97-1-101-86-100"
72,96976,100,43896,140872,17,"40-165-151-162-135-154-121-86-101-49-21-164-27-90-81-92-2-1-97-94-124-148-186-137-80-133-136-53-180-149-43-146-22-159-115-59-161-127-123-184-54-48-65-109-51-176-0-117-93-46-116-10-177-190-4-112-70-75-44-25-78-31-38-145-106-32-14-144-155-9-62-23-18-108-193-5-42-160-34-41-139-143-183-89-120-16-171-175-113-57-55-52-178-33-111-63-79-100-152-185"
73,102830,100,48796,151626,16,"53-52-185-40-165-14-144-62-9-55-179-145-78-121-133-162-47-65-59-89-114-49-106-178-0-117-143-183-33-148-124-94-176-66-140-93-108-69-18-41-42-112-4-84-184-160-96-115-51-86-75-44-120-2-101-1-97-152-21-164-90-81-46-139-36-193-159-22-34-54-177-16-171-113-175-31-154-156-29-127-135-70-194-123-77-43-105-116-151-57-92-129-19-63-80-137-186-23-79-180"
74,103156,100,48196,151352,14,"41-193-115-59-79-120-44-16-171-175-56-113-81-90-27-92-57-49-9-62-130-94-37-148-89-183-143-117-0-35-112-4-127-70-135-151-51-66-176-80-63-136-53-158-154-123-131-184-190-10-177-139-46-137-144-73-21-7-164-165-1-97-152-74-129-78-168-145-3-14-60-42-43-116-65-180-121-101-86-75-2-178-106-31-157-55-52-160-54-48-162-133-172-40-185-181-34-22-18-159"
75,94861,100,43928,138789,16,"102-62-9-178-106-185-81-90-27-164-21-0-143-117-18-159-42-43-194-135-70-127-123-149-131-154-180-162-47-65-116-59-72-176-165-39-14-144-186-148-167-25-16-44-120-124-94-152-2-129-78-145-31-113-175-171-75-86-100-46-139-193-41-160-34-146-103-22-151-133-97-1-101-121-53-63-79-80-66-51-115-5-184-54-177-4-112-119-40-169-196-92-137-183-89-23-55-57-52-49"
76,97783,100,44361,142144,15,"165-91-78-145-2-184-54-177-48-34-160-42-0-148-55-52-106-3-178-57-92-120-75-70-127-123-162-53-101-86-158-154-180-133-151-41-193-159-22-108-18-139-115-59-51-143-117-68-46-43-84-4-112-135-121-19-94-63-122-80-23-89-183-49-196-81-90-40-185-125-1-97-176-137-15-9-62-172-129-25-44-16-171-113-175-56-31-33-167-87-152-79-116-65-144-21-7-164-14-138"
77,89220,100,38016,127236,15,"120-2-151-190-10-177-54-34-146-22-159-46-118-59-162-123-35-184-43-116-115-139-193-41-181-42-65-51-176-130-129-92-145-179-196-81-27-90-165-49-23-0-117-18-160-84-112-70-26-100-94-12-148-37-9-62-102-111-152-172-106-178-52-55-57-40-185-14-144-186-89-183-143-69-108-137-80-79-133-63-121-97-1-75-101-86-53-180-154-135-158-25-78-31-113-56-175-171-16-44"
78,94106,100,44443,138549,20,"162-63-152-2-55-52-106-178-49-9-62-15-186-137-80-122-94-196-81-119-14-144-23-117-0-143-183-89-37-148-66-181-34-160-54-177-184-97-1-57-185-40-179-145-25-44-16-175-171-113-56-31-78-120-70-127-123-135-6-154-180-136-21-164-27-90-165-124-176-51-118-59-151-133-53-101-26-79-46-139-193-41-42-43-65-116-115-68-108-18-22-159-92-129-75-86-112-4-84-149"
79,100186,100,48637,148823,15,"139-193-41-115-60-186-62-102-14-164-7-21-144-9-33-94-122-79-63-97-2-129-92-0-117-93-143-183-49-196-157-56-113-175-171-16-1-133-65-116-43-123-135-154-180-53-86-101-26-100-80-118-108-18-159-22-40-119-185-167-130-176-137-23-89-51-151-162-184-177-10-4-112-29-127-70-75-120-44-78-31-145-179-52-178-106-165-90-81-169-59-42-160-34-54-152-57-55-148-46"
80,98223,100,43800,142023,16,"185-196-113-31-135-127-112-4-123-16-171-175-25-44-120-152-94-124-148-178-106-8-14-144-61-15-186-114-23-137-65-116-43-42-181-193-41-159-22-146-108-93-117-143-176-80-79-121-97-1-40-90-165-12-184-177-10-54-34-160-28-172-52-55-49-62-9-89-183-153-0-46-59-51-66-133-151-139-69-18-115-162-154-180-53-100-136-63-122-26-86-101-145-78-75-150-2-129-92-57"
81,103024,100,50582,153606,15,"3-106-119-40-90-27-165-185-179-91-144-64-15-148-124-129-56-113-175-171-162-159-146-22-18-108-57-92-145-78-120-2-51-60-46-117-143-183-0-109-151-133-136-63-122-80-176-137-23-97-1-152-102-14-21-164-25-44-16-31-55-52-62-9-139-193-41-115-196-81-187-157-75-180-123-160-34-181-42-59-186-114-101-86-100-53-154-135-112-4-177-54-184-43-116-65-79-94-49-178"
82,95414,100,41865,137279,16,"166-162-86-75-25-44-120-94-63-148-49-144-14-78-175-113-171-16-46-68-140-69-18-108-67-93-117-143-90-165-40-185-145-92-129-2-152-74-106-178-51-59-197-5-181-42-43-105-116-65-151-133-154-135-70-127-112-4-84-10-190-177-54-48-160-62-9-15-115-41-96-34-146-22-199-159-193-142-139-0-183-89-23-186-137-176-80-79-26-97-167-52-55-57-1-101-53-180-123-184"
83,98710,100,47418,146128,15,"42-5-144-14-165-27-90-78-25-120-2-97-1-152-9-148-94-63-79-15-114-62-102-49-106-178-135-54-34-181-160-184-29-70-154-53-180-182-100-55-52-185-40-57-92-129-101-86-139-18-108-69-137-145-31-113-175-171-16-44-75-177-10-190-4-112-84-146-22-159-72-133-80-176-0-117-191-41-193-43-65-116-140-93-46-59-51-66-151-162-127-123-149-143-183-89-186-23-115-96"
84,100356,100,48199,148555,16,"48-54-177-190-10-184-86-120-44-196-81-113-175-31-78-145-40-119-185-57-92-2-53-180-154-158-75-171-16-101-136-63-79-133-135-70-194-123-166-115-139-198-151-162-43-42-181-146-22-159-18-108-52-55-165-90-27-49-149-35-84-4-112-127-173-26-97-1-152-189-122-160-34-89-23-186-137-176-51-59-65-116-80-94-148-37-62-9-46-41-193-178-106-14-144-183-143-153-0-117"
85,96911,100,43094,140005,15,"86-4-190-112-70-135-63-79-139-69-18-108-140-93-96-166-35-84-162-122-94-80-176-141-115-41-193-159-146-22-46-49-178-185-40-145-31-78-92-124-59-116-65-151-133-180-154-53-182-172-152-1-97-148-62-9-144-14-165-113-175-171-16-10-177-54-48-184-127-123-105-43-160-34-181-42-118-51-109-137-186-23-89-183-153-143-117-0-189-26-101-75-120-44-52-106-55-57-129-2"
86,94755,100,43906,138661,16,"55-185-119-40-165-106-84-4-112-123-79-122-94-27-90-81-113-31-148-186-23-89-137-66-0-170-143-183-15-62-49-178-87-121-63-51-69-108-18-193-41-25-175-171-16-44-120-100-26-97-152-1-101-86-75-2-14-144-9-80-151-162-149-65-184-177-54-34-181-160-43-116-59-133-53-180-154-135-70-127-5-42-115-198-46-139-159-195-146-22-117-176-129-92-57-179-145-78-196-52"
87,98933,100,46409,145342,16,"80-189-1-97-74-152-62-9-144-14-106-178-49-176-51-46-0-143-90-27-164-21-42-181-160-184-133-100-26-101-2-92-57-151-116-43-166-127-70-180-53-17-81-113-56-13-31-145-179-94-12-124-148-55-52-78-171-175-16-75-86-154-135-54-34-159-18-108-22-146-177-4-112-84-47-65-149-123-162-59-118-115-193-41-139-66-137-183-89-23-186-165-185-40-196-25-44-120-79-63"
88,98189,100,44072,142261,16,"144-95-164-58-39-165-14-102-62-9-153-0-143-21-7-71-27-90-56-113-175-171-16-94-46-108-18-93-117-92-145-168-78-25-82-80-59-65-105-43-116-51-196-98-81-31-44-120-2-1-97-26-121-63-79-115-139-41-193-159-22-181-42-34-54-160-184-123-162-151-133-180-53-86-101-75-70-135-154-152-129-40-185-111-148-176-137-183-89-178-106-91-57-55-52-3-32-49-186-23"
89,96898,100,42051,138949,17,"101-86-53-136-122-80-12-167-57-129-75-158-154-180-92-78-82-2-125-137-23-114-186-94-19-97-63-79-162-65-190-177-10-54-34-181-160-184-28-42-43-105-116-59-51-52-178-106-185-40-123-127-70-135-120-25-44-16-171-175-0-143-183-89-144-14-61-15-176-133-151-72-115-46-139-41-193-159-22-18-108-117-55-91-145-31-113-196-81-27-90-165-32-49-62-9-148-124-152-1"
90,98718,100,47379,146097,15,"183-89-143-160-48-54-30-34-159-110-139-93-117-0-115-116-65-59-162-135-70-127-123-112-86-101-75-113-56-31-78-41-193-18-108-46-176-80-19-145-196-81-90-27-14-155-144-148-130-94-63-53-154-180-43-146-22-181-42-52-55-57-152-97-26-100-1-120-44-16-175-171-25-2-133-151-79-165-119-40-185-4-10-190-177-184-129-92-179-106-178-3-49-62-9-37-114-186-137-23"
91,99832,100,43291,143123,16,"127-70-128-106-178-53-180-154-158-86-44-16-88-171-175-27-90-165-4-112-184-177-10-54-160-193-41-80-56-113-157-14-144-62-9-23-137-94-97-101-75-120-25-78-31-145-162-123-65-59-51-151-133-79-122-63-130-148-33-37-124-152-74-129-92-57-55-176-60-46-139-115-116-43-42-181-34-22-18-117-0-143-183-89-186-49-169-196-38-17-81-40-185-52-2-1-26-100-135-194"
92,98149,100,44481,142630,17,"97-26-53-158-136-124-57-92-79-43-30-54-10-177-184-81-90-40-165-14-144-137-46-110-36-62-9-15-186-89-183-23-12-94-80-176-0-143-117-93-140-2-120-44-75-150-101-63-60-115-139-42-5-160-48-34-146-22-18-159-193-41-181-116-65-131-84-4-112-127-135-70-154-161-123-59-118-109-51-148-49-185-52-145-78-31-113-175-171-16-86-133-151-162-180-1-55-106-178-152"
93,97064,100,43623,140687,17,"54-177-10-190-4-136-97-101-1-75-86-77-43-116-65-72-151-2-120-129-57-52-106-178-14-144-108-18-69-139-115-176-171-175-56-113-196-185-40-165-137-46-68-0-170-143-89-183-186-62-9-148-133-127-112-29-123-45-162-24-84-35-70-53-152-55-49-102-153-117-93-193-41-159-22-146-181-34-160-184-135-154-180-63-79-80-94-124-92-145-78-31-16-44-51-59-96-5-42-48"
94,98104,100,46756,144860,15,"148-12-63-180-154-70-135-127-35-160-34-181-159-117-143-183-89-116-65-59-137-55-52-185-40-95-164-21-108-69-152-78-171-16-44-75-86-133-112-4-177-54-184-79-94-111-178-49-102-62-46-115-118-26-97-1-2-196-81-90-165-138-144-14-106-57-92-145-31-113-175-25-120-101-53-194-123-146-22-199-18-163-51-176-80-151-162-131-77-43-42-41-193-139-0-23-186-15-9-33"
95,97061,100,44457,141518,15,"1-2-196-81-90-165-7-164-21-46-198-117-0-176-80-94-12-148-144-155-14-49-62-9-15-137-115-139-93-140-97-101-86-53-63-79-133-162-194-135-127-123-131-59-118-60-23-186-57-92-145-78-113-31-40-185-106-52-55-172-152-180-4-84-34-146-22-18-159-193-41-160-10-177-54-48-42-143-183-89-51-151-75-16-171-175-44-120-129-32-178-65-116-43-184-11-35-112-70-154"
96,100394,100,45730,146124,17,"119-14-144-183-143-89-23-186-92-78-56-50-113-44-75-70-112-4-135-154-53-86-101-97-1-148-9-62-137-46-191-139-115-197-118-49-165-27-90-40-57-129-2-125-152-72-65-116-120-16-171-175-31-145-55-52-106-178-172-94-43-42-160-48-30-54-180-136-63-79-133-151-45-59-69-108-18-181-123-127-162-80-176-51-159-22-146-34-177-10-190-84-184-5-41-193-93-117-0-185"
97,104132,100,48955,153087,16,"144-14-102-62-80-151-77-43-60-23-186-137-94-97-152-172-55-52-148-51-65-116-49-178-106-185-179-57-63-133-162-160-181-34-30-10-190-4-112-70-175-113-31-78-145-92-129-101-150-25-16-171-86-184-48-54-177-84-126-127-75-44-120-82-2-1-26-121-143-0-176-79-180-154-6-135-24-123-53-165-40-9-46-159-22-18-69-108-139-115-118-59-131-166-42-41-193-117-183-89"
98,97460,100,43333,140793,17,"73-114-89-183-143-0-23-186-14-90-81-113-56-175-171-16-44-120-133-151-47-65-77-184-43-116-59-60-137-9-37-148-176-51-80-122-129-92-57-55-52-139-159-193-41-79-63-100-53-180-135-123-112-4-127-70-154-2-78-31-145-172-128-49-32-178-3-106-165-40-185-10-177-54-34-22-18-108-69-42-5-115-46-117-140-93-146-103-160-162-86-75-1-101-152-97-94-12-62-144"
99,104705,100,49220,153925,16,"181-160-184-167-106-178-32-148-176-137-183-89-23-186-172-129-92-1-101-86-53-70-135-127-123-116-65-43-42-41-0-153-57-55-52-49-62-9-152-2-196-81-113-175-171-16-44-120-75-121-136-133-54-34-103-146-22-20-18-164-27-90-40-189-80-51-198-115-139-46-144-14-165-185-151-118-59-45-162-154-180-63-79-94-12-111-128-145-38-31-56-78-97-193-159-69-108-140-143-117"
100,100967,100,48479,149446,17,"148-43-160-184-86-75-120-25-44-16-171-175-113-137-0-117-93-143-183-89-186-102-49-14-178-106-52-55-57-152-94-63-133-79-180-158-53-101-1-97-115-41-193-159-146-195-181-109-66-51-149-112-123-128-185-40-81-196-31-78-145-151-116-65-167-165-90-27-164-144-42-192-34-103-22-18-139-46-118-59-162-173-154-70-135-127-84-190-10-177-30-54-2-129-92-176-80-62-9-33"
101,105272,100,52716,157988,16,"70-4-112-75-120-44-2-152-74-145-196-81-157-31-113-78-86-53-123-131-197-115-139-41-193-18-108-178-106-148-176-42-146-22-159-40-165-39-90-27-62-9-15-79-63-55-52-185-111-94-180-154-135-127-177-54-34-181-160-184-24-99-129-92-57-65-116-43-198-46-140-93-117-51-151-133-162-59-118-23-186-144-14-102-49-1-97-100-0-170-143-89-183-137-80-121-101-171-175-16"
102,106264,100,52889,159153,16,"175-78-92-176-115-41-193-181-34-54-48-160-145-168-157-81-196-86-70-135-154-180-53-136-121-9-62-49-178-3-106-14-144-183-143-0-131-112-127-75-44-120-23-117-93-140-152-87-2-129-57-55-91-40-185-52-1-97-101-26-63-151-59-51-80-31-113-16-42-159-22-18-108-68-139-198-46-137-111-148-15-122-94-27-90-165-79-133-162-123-24-190-10-177-184-43-105-116-65-171"
103,94632,100,42509,137141,17,"113-171-175-16-70-177-54-34-22-18-108-69-159-193-41-42-162-180-53-100-97-1-101-75-86-123-131-65-116-115-46-62-49-14-3-178-167-63-84-4-112-127-135-154-57-55-92-129-152-19-51-0-143-183-89-15-9-148-59-43-160-184-79-94-52-106-165-90-21-144-64-114-23-186-137-176-80-133-151-198-139-110-140-93-117-76-12-124-2-120-44-25-82-78-145-40-185-81-196-31"
104,95838,100,45248,141086,16,"124-148-37-152-1-101-120-25-44-75-86-182-63-79-133-80-23-186-137-176-94-129-82-2-59-43-42-181-139-46-40-165-90-81-196-57-41-193-159-22-18-108-69-68-0-117-143-183-89-144-14-138-106-55-52-62-64-114-15-9-145-31-175-113-185-178-49-72-35-84-184-105-116-65-115-198-51-92-78-171-16-123-34-160-54-10-177-4-112-127-135-70-154-151-162-180-53-100-26-97"
105,98699,100,43920,142619,16,"54-133-87-78-31-56-145-111-148-186-23-37-128-55-52-57-53-70-112-4-84-184-160-181-42-59-61-144-14-138-178-49-15-89-137-94-86-101-150-75-113-175-171-16-2-122-46-0-117-143-183-106-185-40-196-81-90-27-165-164-62-9-176-51-118-115-193-41-43-131-123-127-135-154-180-162-65-105-116-151-79-63-152-74-125-97-1-120-44-25-129-92-80-139-108-18-22-146-34-177"
106,98297,100,43959,142256,15,"97-189-92-129-152-125-94-130-153-0-46-198-139-115-43-35-84-112-123-164-27-90-165-33-133-45-162-154-180-53-182-63-22-146-42-116-86-101-2-57-55-138-14-144-49-106-178-196-81-40-185-52-51-59-159-18-108-69-193-41-181-34-160-54-184-65-151-148-9-62-186-140-93-117-143-176-122-80-137-183-89-23-79-6-135-127-70-16-171-175-56-113-31-78-145-44-25-120-75-1"
107,99907,100,47550,147457,18,"120-44-25-82-129-152-74-57-92-179-185-40-91-145-78-16-2-1-97-100-26-158-53-135-112-160-34-18-143-183-89-23-186-114-62-144-14-106-178-59-65-116-46-0-170-139-41-193-5-115-60-51-176-137-9-37-148-149-123-196-81-90-165-105-43-42-181-22-159-47-162-151-133-154-180-79-63-101-171-175-113-56-31-94-122-80-93-140-117-49-52-55-184-54-177-4-127-70-86-75"
108,98188,100,46065,144253,16,"23-186-73-144-178-113-175-16-171-56-157-7-164-95-165-119-40-185-57-129-152-124-111-145-31-78-63-151-160-54-177-4-162-133-154-135-70-127-123-65-139-93-117-143-183-0-68-46-62-9-59-181-34-42-116-47-43-28-184-121-26-120-44-25-86-53-158-180-79-80-176-94-97-1-101-75-2-92-81-90-27-106-52-55-17-196-51-137-148-33-14-49-115-41-193-159-22-18-108-89"
109,92797,100,41523,134320,15,"139-115-116-65-149-131-161-180-53-26-59-41-193-159-22-146-123-127-135-173-11-184-177-54-34-181-96-109-51-151-79-63-80-176-9-62-148-154-70-112-4-84-160-42-43-162-133-97-1-196-81-40-165-90-27-164-21-144-23-186-49-178-55-57-92-25-44-120-2-152-46-117-0-137-129-145-78-31-185-14-138-106-52-113-171-175-16-75-86-101-94-130-89-183-143-93-140-108-18-69"
110,97881,100,44172,142053,16,"148-135-70-133-137-23-186-129-92-145-78-82-75-86-154-180-53-101-1-97-19-94-89-183-117-143-0-124-152-125-162-159-22-18-108-69-93-140-46-110-139-96-84-112-127-123-21-164-27-90-81-196-40-165-119-185-55-52-57-189-63-79-80-176-51-66-109-59-115-193-41-34-160-48-54-177-184-106-178-49-42-43-116-65-151-9-62-16-171-175-113-31-13-25-44-120-2-87-14-144"
111,96598,100,44101,140699,19,"175-113-56-31-78-25-120-44-128-167-102-14-49-32-178-106-185-40-57-129-2-172-9-62-37-148-94-79-63-182-26-97-152-55-52-23-186-114-144-39-27-90-165-183-89-196-81-145-92-117-93-140-36-59-118-41-193-42-43-65-116-115-46-139-159-160-34-146-22-18-176-80-1-101-86-53-158-180-137-0-143-21-164-7-121-154-70-135-133-51-151-162-123-184-84-112-127-75-16-171"
112,101260,100,49141,150401,15,"183-0-181-34-54-177-10-112-4-154-53-86-101-3-49-33-152-1-2-129-145-78-75-150-97-15-23-137-46-22-159-140-93-117-68-160-48-184-63-55-52-79-43-42-193-41-9-102-62-143-108-18-69-171-16-175-56-113-31-157-57-167-94-121-136-180-135-35-65-116-139-115-59-123-127-70-162-72-151-133-80-51-176-148-178-106-8-92-82-120-44-25-185-40-90-165-14-144-186-89"
113,96740,100,43487,140227,19,"157-145-128-41-193-181-34-160-182-121-101-120-44-16-171-175-56-113-183-143-46-139-115-59-162-135-70-127-54-48-184-123-154-158-180-0-117-108-18-22-42-43-65-116-109-51-176-148-165-90-27-81-40-169-196-78-25-75-86-53-10-177-4-112-80-130-12-124-94-152-2-129-92-57-55-52-106-185-178-49-114-89-23-186-15-9-62-14-144-137-60-151-133-79-122-63-189-97-1-31"
114,98919,100,46333,145252,14,"133-120-82-178-49-9-62-186-89-108-18-193-105-151-2-129-57-55-52-185-165-8-59-65-116-117-143-183-21-90-81-40-106-148-167-102-144-14-31-56-113-175-171-16-79-115-139-68-0-23-137-63-136-180-154-158-86-75-44-25-145-78-92-94-176-51-198-46-80-100-101-1-125-152-97-53-70-127-43-41-159-22-146-34-4-112-84-184-42-181-160-54-177-10-135-173-162-123-11-47"
115,94753,100,43697,138450,19,"42-103-146-159-193-59-80-79-151-72-65-47-116-43-184-123-75-120-106-21-7-164-39-165-185-55-52-101-86-53-158-173-133-162-127-70-135-154-180-12-23-89-0-41-181-160-54-48-63-94-152-129-145-78-171-16-175-113-56-31-81-90-27-40-2-1-97-167-49-102-137-46-139-115-51-62-9-144-14-32-178-186-183-143-117-18-22-34-30-177-190-10-4-112-44-25-92-57-148-176"
116,92539,100,41143,133682,16,"140-93-0-117-143-23-137-176-80-94-130-124-100-86-101-62-9-148-112-4-190-10-177-54-160-181-34-146-22-183-89-186-49-106-178-185-174-81-196-113-175-171-16-78-145-92-129-2-53-180-154-184-42-43-59-144-14-95-165-52-55-57-157-31-56-90-27-40-152-97-189-118-41-193-159-108-18-46-51-109-151-79-63-1-120-44-25-75-133-116-65-162-135-6-70-127-123-115-198-139"
117,96487,100,44427,140914,17,"148-137-51-112-4-84-115-139-198-21-7-164-27-90-165-52-55-145-31-56-113-78-43-42-160-48-184-166-11-127-135-70-177-54-34-41-59-72-80-1-97-46-68-117-143-0-183-89-23-19-152-2-120-44-92-57-129-101-180-154-159-146-22-18-69-108-193-186-144-14-3-178-106-185-40-119-196-81-175-171-16-75-86-53-63-79-133-116-65-123-162-151-176-9-62-49-94-124-37-33"
118,95659,100,46606,142265,19,"22-146-103-30-177-84-112-70-101-81-90-165-21-144-62-9-148-94-79-80-176-0-117-143-185-145-179-92-151-42-181-34-123-180-53-97-1-152-106-178-52-55-57-129-154-135-127-4-10-190-35-11-184-54-48-160-149-162-133-86-75-120-44-25-16-171-175-113-2-63-96-5-193-41-159-18-108-69-23-186-137-59-116-65-43-115-46-139-68-183-89-15-49-14-138-40-196-31-78-51"
119,100361,100,49679,150040,17,"16-112-4-10-177-131-176-21-164-90-40-165-185-117-93-108-18-69-140-144-14-49-62-9-159-22-146-53-86-150-75-101-1-97-189-63-133-162-47-65-79-92-129-100-26-152-55-57-145-31-113-56-105-116-43-42-96-59-151-180-154-135-70-127-160-34-103-195-193-41-139-46-0-143-183-89-186-23-137-148-167-106-178-52-78-25-120-2-94-80-51-115-181-48-54-184-123-44-175-171"
120,102416,100,45916,148332,14,"116-65-43-139-140-93-181-34-160-22-108-18-159-193-41-115-51-94-152-2-120-82-129-172-9-62-49-14-3-37-167-111-148-23-186-21-90-81-78-44-75-86-53-180-63-79-122-80-176-141-143-183-89-144-155-48-54-177-184-133-185-165-39-40-38-85-31-145-92-57-121-154-135-127-123-70-16-171-113-175-52-55-178-106-128-161-28-42-5-151-189-101-1-97-137-0-117-46-59-162"
121,99093,100,45810,144903,16,"89-21-164-7-144-192-160-34-22-159-43-79-63-129-52-55-57-92-25-44-1-101-2-90-27-165-8-111-137-23-176-80-122-94-106-178-49-14-185-40-81-157-145-120-75-86-149-184-48-54-177-16-171-175-113-154-123-84-4-112-127-70-135-194-162-133-182-26-97-152-37-148-9-62-102-196-85-31-56-78-53-180-105-65-116-59-151-51-46-68-139-193-41-42-96-115-0-117-143-183"
122,101767,100,50048,151815,17,"149-22-18-108-69-92-145-78-75-86-112-4-10-177-184-43-42-160-34-181-159-117-143-0-2-120-44-25-16-127-30-54-48-115-118-59-197-51-80-176-148-128-52-55-101-1-152-9-62-61-144-14-57-129-151-105-65-116-185-165-40-31-171-175-113-81-90-164-21-114-46-139-193-41-178-106-3-15-186-89-183-23-137-79-63-180-182-94-102-49-172-97-26-53-154-135-70-133-162-123"
123,94364,100,42719,137083,15,"137-23-65-43-160-48-54-184-25-44-78-56-113-175-171-16-31-81-90-165-62-9-139-41-193-69-18-108-70-135-145-7-164-21-178-106-55-52-40-185-14-155-144-49-167-152-129-92-120-2-97-1-101-75-86-194-162-133-63-121-53-180-154-151-59-115-198-46-89-83-186-80-79-94-148-15-183-0-143-117-177-190-10-4-112-127-123-77-42-159-22-103-146-34-181-5-96-116-51-176"
124,97376,100,45009,142385,16,"65-116-123-127-70-75-56-31-120-154-135-41-193-159-18-69-180-53-86-101-1-97-137-0-68-46-51-176-151-133-79-80-148-9-62-15-93-108-144-14-178-106-44-25-40-119-50-113-175-171-16-78-145-196-81-90-165-49-94-130-19-152-74-55-52-185-179-92-57-129-2-63-162-34-146-22-181-117-143-183-89-23-42-160-48-30-54-177-10-4-112-184-43-198-36-140-110-139-115-59"
125,101358,100,47190,148548,17,"46-148-40-119-81-17-196-185-52-172-87-152-97-1-75-101-86-100-26-99-182-32-138-14-144-115-42-41-193-159-181-160-54-177-112-127-135-154-55-57-92-25-120-2-53-180-164-27-90-165-151-65-116-59-137-23-186-15-62-49-106-178-9-89-183-93-140-108-18-22-34-184-43-162-133-79-63-80-176-143-117-0-131-123-70-44-16-31-145-78-129-12-130-94-113-175-171-51-139-110"
126,103463,100,51727,155190,16,"0-39-90-27-132-89-183-23-130-124-106-178-14-49-152-97-1-2-120-44-16-171-175-113-139-159-193-41-51-92-145-78-38-196-81-85-56-31-75-135-123-160-34-181-42-184-112-4-10-177-54-127-70-86-101-129-57-62-9-80-151-133-79-63-94-148-144-102-53-180-154-176-137-186-114-138-165-40-169-185-8-143-117-93-18-108-22-146-43-116-65-21-164-7-52-55-162-59-115-46"
127,98571,100,45820,144391,15,"184-4-112-127-2-129-120-44-145-91-178-106-52-57-55-49-186-137-130-148-9-62-94-182-180-154-135-162-133-151-59-116-47-65-79-80-176-0-117-143-140-93-193-159-22-181-146-160-34-54-10-177-190-128-111-152-121-136-53-101-1-97-26-18-69-108-183-89-23-46-110-139-115-144-14-196-113-175-171-16-31-78-63-51-41-42-43-131-123-70-86-75-92-185-119-40-90-27-165-3"
128,98641,100,46683,145324,15,"137-180-135-123-181-103-146-117-143-170-0-68-139-115-51-176-62-9-148-162-84-4-112-86-75-120-78-145-196-81-90-165-39-12-133-80-138-178-3-94-79-63-189-97-129-92-2-101-1-26-53-154-70-127-184-28-160-177-190-10-54-34-22-18-108-159-193-191-183-114-102-49-124-152-44-16-175-171-113-31-40-185-106-52-55-151-47-65-59-32-14-144-46-41-42-43-116-89-23-186"
129,100320,100,44944,145264,15,"164-7-27-90-52-55-151-47-77-43-116-65-197-115-42-5-41-193-159-22-139-154-180-70-135-127-123-133-63-92-129-152-94-68-18-69-108-148-62-9-61-49-111-79-162-184-54-160-34-181-59-51-137-186-23-0-117-143-183-144-14-165-40-113-171-175-16-145-78-2-101-1-3-32-89-153-46-176-80-97-120-44-57-178-106-185-81-188-56-31-157-196-169-91-75-86-53-158-124-21"
130,98997,100,46213,145210,16,"116-55-52-133-151-59-118-46-0-183-89-23-94-121-53-180-115-108-18-41-5-162-182-26-100-154-135-112-4-190-10-177-28-77-51-176-145-31-78-25-44-16-175-171-56-113-85-57-143-117-198-139-68-93-140-142-193-159-22-146-34-123-70-127-184-54-160-42-43-129-92-120-75-86-136-63-79-80-137-186-152-97-1-101-2-49-9-62-148-124-106-178-165-90-40-185-14-144-60-65"
131,98407,100,43750,142157,14,"193-41-139-106-185-179-78-145-92-162-30-54-48-59-151-79-122-133-123-29-112-4-84-184-43-5-42-159-22-34-160-116-65-135-70-189-49-62-9-148-46-140-93-117-144-14-138-178-172-152-94-176-137-23-89-183-143-0-51-80-63-180-158-154-53-101-2-129-40-165-90-56-171-175-113-81-187-196-31-16-25-44-120-75-86-173-127-190-10-177-131-149-99-55-52-57-1-97-19-115"
132,92508,100,40680,133188,17,"119-165-8-52-55-106-138-14-144-49-62-61-9-89-183-143-108-18-22-159-116-65-77-35-112-44-25-145-78-92-129-12-137-176-80-180-154-135-70-127-123-131-184-34-160-54-177-21-7-164-27-90-39-81-196-57-109-59-115-93-117-0-46-139-41-193-42-43-79-94-121-86-75-16-171-113-175-56-157-31-120-2-101-53-136-63-133-151-162-51-186-23-148-3-178-152-1-97-185-40"
133,101432,100,48926,150358,17,"149-131-133-63-152-2-129-57-140-93-117-170-143-183-89-49-3-196-31-56-81-90-165-79-184-30-54-177-10-162-151-80-176-66-137-186-114-15-62-14-21-144-23-76-160-48-34-193-41-42-5-65-53-86-101-97-1-26-189-0-46-139-115-118-51-130-148-9-180-154-70-127-123-135-6-75-120-78-145-92-106-178-185-40-52-55-94-59-116-43-181-22-159-18-16-171-175-113-25-44"
134,100936,100,47604,148540,17,"162-133-79-122-63-180-135-154-57-52-55-152-2-185-8-116-65-47-127-123-112-84-4-184-160-34-103-42-94-128-167-124-1-101-75-44-120-16-171-175-183-143-117-93-139-46-89-138-39-90-113-31-78-86-158-53-26-97-40-119-165-0-108-18-193-41-181-146-22-159-96-115-59-151-51-144-14-178-3-106-145-92-49-186-23-137-176-80-130-148-9-62-43-54-177-10-190-11-131-149"
135,94620,100,40589,135209,16,"137-46-115-197-72-151-131-11-35-127-75-44-120-82-92-55-138-14-144-62-148-63-180-135-70-154-86-16-175-171-113-56-31-145-78-176-41-193-18-108-117-9-178-106-52-167-12-130-94-100-121-53-123-184-34-22-146-159-42-116-43-65-59-51-80-97-101-1-152-89-183-170-143-0-139-160-54-177-84-190-10-4-112-126-162-133-79-87-2-129-57-185-165-27-90-81-40-49-186-23"
136,94546,100,41751,136297,16,"175-171-113-31-185-40-90-165-8-14-49-152-97-1-99-94-137-186-23-183-89-181-160-177-10-190-184-42-43-41-193-115-9-62-37-148-87-178-106-52-55-92-78-145-25-120-75-70-127-112-4-84-0-143-117-146-34-30-54-48-151-79-80-118-159-22-18-108-69-139-198-15-144-57-129-2-101-53-63-176-93-140-46-51-133-180-154-135-123-77-47-116-65-59-162-161-158-86-44-16"
137,101899,100,46527,148426,18,"34-160-43-162-182-53-26-63-79-80-51-108-69-18-22-42-116-65-148-178-106-57-92-16-88-171-78-145-179-55-9-62-49-27-90-81-196-111-124-94-122-33-21-7-58-164-129-2-101-86-70-135-173-133-176-137-89-183-143-93-117-0-180-154-158-127-177-184-123-75-120-40-165-185-52-152-1-97-115-193-41-59-151-44-113-175-56-31-91-32-138-14-155-73-144-23-46-139-159-181"
138,95813,100,43512,139325,16,"193-22-18-139-137-119-40-185-52-42-181-65-129-78-145-196-81-90-27-164-165-53-158-86-101-1-2-16-175-171-113-31-55-15-186-23-89-183-143-117-0-93-140-46-59-72-151-133-35-84-162-135-70-154-180-63-94-128-178-106-32-14-49-74-152-97-148-9-62-144-155-57-92-25-44-120-75-127-123-131-176-80-66-51-116-43-184-160-34-54-10-177-4-112-182-100-26-79-115-41"
139,100150,100,46210,146360,15,"2-120-44-25-75-180-59-116-65-42-181-146-22-34-160-54-177-152-129-82-92-57-55-154-135-93-140-117-89-83-183-143-0-68-46-115-43-184-162-45-151-133-79-178-164-21-144-14-49-123-127-70-16-171-175-113-31-100-26-97-185-40-90-165-106-33-148-12-130-63-122-80-69-108-18-159-193-41-139-51-176-145-78-179-52-9-15-114-186-23-137-141-73-62-94-121-53-86-101-1"
140,94756,100,42672,137428,16,"175-171-162-123-127-135-154-133-80-79-86-75-150-101-1-152-148-37-9-62-137-0-117-46-139-34-54-177-48-160-181-42-116-51-176-151-72-59-65-47-149-49-178-106-74-97-53-158-180-63-94-19-165-39-40-185-57-92-78-145-196-174-81-31-113-16-44-25-55-52-14-144-143-69-108-18-43-112-4-184-41-193-159-146-22-115-124-2-120-129-15-186-23-89-183-114-21-7-164-90"
141,97844,100,45409,143253,17,"68-139-191-193-159-181-41-176-80-124-167-178-106-94-79-151-116-65-162-133-70-135-127-123-184-160-34-22-108-18-21-164-81-196-2-101-53-154-180-100-57-55-52-185-165-90-27-144-61-15-89-183-93-140-152-78-38-31-50-56-40-119-179-145-102-49-9-62-148-186-23-46-198-115-51-63-26-86-75-25-113-175-171-16-44-120-129-92-138-14-1-97-121-43-42-59-137-0-143-117"
142,96141,100,44378,140519,17,"151-133-120-44-25-52-55-184-48-160-181-34-54-30-42-115-0-23-144-62-9-148-124-106-165-40-185-1-101-86-26-97-100-53-180-123-149-162-178-49-14-137-46-139-191-41-96-43-65-116-197-59-72-75-16-171-175-118-193-159-146-22-103-177-10-190-84-4-112-127-136-121-78-56-113-31-145-92-129-57-2-152-94-176-80-79-63-154-70-135-69-18-108-140-93-117-143-183-89-51"
143,91037,100,35229,126266,15,"151-65-77-184-84-35-162-79-63-182-2-129-152-80-59-116-43-42-159-22-193-41-139-46-51-137-23-89-186-144-155-14-37-176-115-160-181-34-54-177-4-112-123-127-0-117-143-183-9-62-49-178-106-52-55-185-165-39-164-27-90-40-81-113-175-171-31-145-179-78-16-25-44-120-75-70-135-154-180-86-150-101-82-92-57-128-33-111-148-189-26-1-97-12-130-94-100-53-136-133"
144,101189,100,49203,150392,13,"57-133-184-48-160-40-90-165-49-148-94-182-136-63-80-176-178-106-52-55-105-43-42-181-149-154-53-180-79-0-117-115-116-65-118-137-21-164-27-81-196-120-75-86-135-127-112-4-177-54-34-146-22-159-191-139-46-23-186-144-14-185-168-31-56-113-101-1-151-41-193-18-69-108-9-62-89-183-143-51-59-131-24-123-162-100-97-152-2-175-171-88-16-44-25-129-92-145-78-179"
145,98133,100,45546,143679,16,"18-69-139-79-63-136-97-196-81-90-165-49-115-193-41-5-181-34-160-48-54-177-10-57-55-152-121-182-180-162-65-116-59-151-133-80-137-23-183-89-144-14-106-178-52-2-1-101-158-6-135-127-112-4-84-184-123-70-86-75-120-44-25-40-8-185-53-154-194-131-77-43-42-51-62-9-37-148-46-191-159-22-140-93-117-143-0-176-94-16-175-171-113-31-78-145-92-82-129-108"
146,100391,100,46330,146721,16,"136-182-152-196-81-90-40-52-55-108-69-18-159-161-162-184-10-190-177-54-160-78-113-31-175-171-16-4-112-156-29-127-94-57-185-165-14-114-186-23-41-193-151-133-135-70-123-24-131-72-51-59-65-116-22-34-42-43-105-197-0-153-183-89-137-12-124-148-9-62-92-145-106-178-49-144-15-46-115-139-93-140-117-143-176-80-79-63-2-120-44-75-1-97-26-53-180-154-101-86"
147,106258,100,53761,160019,16,"183-89-139-41-193-0-143-153-23-15-62-144-14-138-49-148-197-195-181-48-160-184-180-1-101-75-86-177-54-34-146-22-159-140-93-117-27-90-81-80-51-176-178-106-185-40-167-94-79-133-162-123-24-171-175-113-31-52-9-114-186-137-109-59-116-43-42-115-46-21-7-95-164-165-152-63-151-72-142-18-108-69-2-129-145-78-16-44-120-92-55-57-97-53-154-70-135-127-28-65"
148,97620,100,45977,143597,15,"137-186-144-14-165-40-185-106-115-41-139-170-143-183-89-23-24-112-35-184-34-181-193-42-116-65-59-72-176-148-49-102-62-9-159-22-146-149-152-129-78-16-171-175-113-31-81-196-145-92-57-94-151-47-131-123-127-86-1-97-53-180-158-154-105-43-160-48-54-177-190-10-4-63-124-178-52-55-2-101-75-44-120-108-69-18-162-70-135-194-133-79-80-0-117-93-140-46-109-51"
149,97064,100,44742,141806,14,"97-4-112-184-177-10-54-160-28-137-62-155-144-49-57-175-171-16-25-44-120-75-101-94-23-183-89-186-9-106-185-196-81-138-14-143-159-146-22-34-181-42-43-65-151-133-53-86-2-82-70-127-123-46-93-117-0-80-180-154-135-161-162-79-128-178-52-55-145-31-56-113-13-78-92-129-152-124-130-148-21-164-27-90-165-119-40-176-51-59-116-41-193-108-18-139-115-72-63-1"
150,97680,100,43507,141187,15,"42-59-141-51-118-115-139-193-41-5-116-53-86-100-49-14-144-183-143-153-89-186-23-137-80-176-68-46-63-189-152-74-97-101-1-125-62-9-178-106-145-175-171-16-78-44-120-2-75-129-92-57-108-18-22-34-160-184-43-65-151-52-40-185-8-165-90-81-55-172-94-79-133-162-194-135-154-180-158-70-127-112-4-10-177-54-123-148-138-7-164-21-0-117-140-93-159-146-103-181"
151,94836,100,43216,138052,16,"186-89-183-143-23-137-124-152-97-1-2-82-145-40-164-7-106-101-135-123-177-54-34-160-43-42-184-84-4-112-127-70-16-171-175-113-25-44-120-78-31-81-90-27-165-49-148-12-80-176-133-151-41-193-93-117-0-46-115-139-116-59-51-9-62-144-14-32-3-178-167-189-94-79-63-180-154-159-18-22-195-146-103-181-65-162-53-86-75-55-52-57-92-129-15-114-64-185-196-17"
152,100225,100,49563,149788,15,"59-115-139-46-178-49-62-9-37-109-5-146-22-159-193-41-42-43-131-53-1-2-55-106-52-94-80-51-118-151-79-133-184-177-4-112-70-171-175-113-196-81-169-185-40-27-90-165-14-144-68-163-108-69-154-180-162-65-47-123-127-135-86-16-31-78-145-44-25-120-75-101-97-26-176-117-93-18-34-160-116-137-186-23-183-89-15-148-170-0-143-73-21-164-7-57-92-129-152-63"
153,99278,100,46567,145845,15,"101-86-75-2-52-185-119-40-90-165-138-106-129-92-57-55-177-54-48-34-160-184-44-16-25-120-69-18-108-143-183-89-23-137-79-180-154-123-181-22-146-159-186-15-144-14-3-178-78-145-148-37-117-93-140-63-182-26-189-94-80-51-96-42-43-41-193-110-139-115-116-59-72-151-162-133-176-153-0-46-47-65-35-84-4-112-135-53-171-113-175-31-49-9-62-124-19-152-1-97"
154,95833,100,43297,139130,18,"189-180-53-86-75-92-57-55-52-179-113-175-171-16-4-10-190-123-122-94-124-137-144-14-49-62-9-148-152-1-97-99-136-63-133-151-51-109-59-116-181-34-146-22-159-140-93-117-46-115-65-84-112-127-70-135-154-79-80-41-193-118-120-44-25-78-2-101-162-161-149-43-184-177-54-160-42-0-143-183-89-23-108-18-69-139-60-176-145-31-185-40-165-27-90-164-7-106-178-74"
155,100304,100,45888,146192,16,"127-135-31-85-113-56-40-14-89-183-143-0-46-139-137-33-148-176-80-122-99-196-81-90-164-21-144-62-9-94-124-152-97-1-171-175-16-44-101-26-100-162-149-65-59-51-138-165-185-133-166-43-77-178-106-3-49-114-186-23-117-93-108-18-193-115-116-105-151-79-63-180-154-158-53-86-92-57-52-55-128-74-2-78-145-120-75-70-112-177-54-34-22-159-41-5-42-160-184-123"
156,101279,100,48289,149568,14,"186-22-159-193-41-94-129-57-49-148-111-101-86-75-120-196-165-39-90-27-14-130-176-0-170-139-115-59-151-80-79-63-133-180-154-53-158-189-55-185-40-119-125-2-92-145-179-114-183-143-117-93-140-69-108-18-146-34-54-10-177-4-112-62-9-162-131-43-116-51-137-23-89-46-65-123-135-70-127-184-160-42-56-113-31-78-52-178-3-106-175-171-16-44-1-97-152-102-155-144"
157,105607,100,49442,155049,15,"41-193-123-135-180-136-148-9-62-37-111-152-97-1-125-178-106-185-52-55-92-120-44-25-78-31-38-196-165-7-164-21-138-14-102-144-186-23-42-160-184-43-47-116-115-46-137-57-129-75-150-79-60-0-117-159-22-146-34-177-54-154-53-86-63-122-80-51-176-49-40-81-187-90-27-2-101-99-133-162-65-59-72-151-94-145-168-89-183-143-93-108-18-139-113-175-171-16-4-112"
158,92791,100,43224,136015,19,"52-62-9-186-23-89-137-59-43-116-65-151-152-31-113-56-17-95-7-164-90-27-81-119-40-185-179-92-129-2-101-1-26-121-53-180-154-63-133-162-160-34-146-22-159-193-165-39-14-144-183-143-0-117-42-5-69-18-108-140-93-57-145-196-106-178-49-148-94-122-79-123-184-177-10-190-4-112-127-70-135-86-75-16-175-171-78-25-44-120-97-80-51-46-68-139-41-115-176-55"
159,102165,100,43774,145939,17,"112-177-54-34-0-117-143-80-176-137-23-9-62-37-109-51-46-115-139-18-22-159-57-92-175-171-16-44-120-75-158-70-127-123-24-65-59-33-49-14-144-73-183-153-94-97-101-86-121-136-180-133-41-193-116-162-151-28-184-160-42-43-12-111-167-152-125-63-79-122-148-15-89-186-114-64-61-52-55-145-78-113-31-106-178-32-185-40-165-90-27-81-98-196-129-2-1-53-154-135"
160,101366,100,49377,150743,15,"161-135-154-2-82-129-74-137-93-140-108-18-86-101-120-78-145-196-90-81-141-160-181-42-186-144-21-164-165-185-40-14-89-183-0-10-190-177-54-34-159-117-143-23-178-3-94-79-22-146-184-84-4-112-28-59-51-176-80-148-62-9-49-152-1-97-63-133-151-45-162-180-53-52-106-55-57-92-31-113-175-171-16-44-75-70-127-123-149-131-116-65-43-41-193-191-139-68-46-115"
161,99018,100,46310,145328,15,"51-59-46-117-0-143-176-180-154-70-127-4-112-177-54-30-48-43-65-116-197-151-162-149-42-181-22-18-139-16-88-171-81-196-38-145-78-2-152-37-148-172-57-92-129-94-122-79-133-63-124-165-90-27-25-120-44-75-101-86-97-1-55-52-106-179-31-113-175-56-157-40-185-178-49-89-183-137-80-136-53-135-123-184-160-34-159-9-15-186-23-41-193-115-66-62-144-21-164-14"
162,97141,100,43827,140968,17,"178-3-14-49-33-148-16-171-154-70-4-112-127-123-47-65-116-43-42-184-177-54-30-48-34-160-59-162-151-133-194-135-75-25-44-120-1-101-150-86-180-53-129-92-57-111-12-176-80-72-109-51-137-89-183-143-0-117-97-2-78-145-31-196-81-40-185-52-55-94-63-79-90-27-164-41-193-159-146-22-69-18-108-139-115-46-23-186-15-9-113-175-56-165-138-144-62-74-152-106"
163,96961,100,45262,142223,15,"176-66-51-80-124-94-79-133-63-189-52-55-178-106-40-185-165-138-21-23-137-46-198-139-191-193-41-5-131-24-180-154-135-70-127-123-162-151-56-113-175-171-16-43-181-42-116-65-129-92-145-31-78-25-44-120-57-90-164-7-15-186-89-183-108-18-69-159-115-118-59-125-152-1-97-112-4-10-177-184-160-68-143-0-117-93-22-146-34-53-86-75-101-2-49-144-14-62-9-148"
164,100443,100,47275,147718,16,"193-115-51-152-92-81-90-40-178-79-133-151-72-65-47-43-160-54-177-10-184-24-123-127-101-196-169-185-106-111-94-124-19-182-63-80-176-144-21-164-7-165-70-135-162-34-22-159-183-89-15-14-32-49-62-9-69-108-18-139-46-137-148-37-33-0-140-93-117-143-23-186-145-78-25-44-120-75-2-31-175-113-171-16-86-53-154-180-26-97-1-129-57-55-52-59-116-42-96-41"
165,95288,100,38042,133330,19,"86-150-101-1-2-128-40-185-90-165-102-59-116-43-123-135-154-180-53-121-182-133-151-75-120-85-31-113-175-171-16-44-57-106-32-138-14-144-62-9-129-82-78-145-92-51-115-22-18-108-140-93-117-143-153-183-89-186-23-137-176-80-79-63-189-97-26-47-65-162-152-125-87-94-122-124-148-37-49-3-178-52-55-15-60-0-46-139-193-41-42-160-34-184-54-177-4-112-70-100"
166,98075,100,45673,143748,15,"148-180-154-53-86-44-113-56-81-27-90-165-185-52-55-1-97-19-94-186-23-124-101-75-120-82-145-78-92-57-7-164-21-144-127-112-70-135-6-74-152-2-129-137-0-117-93-18-108-22-159-143-183-89-114-25-16-175-171-31-196-40-14-49-59-116-43-65-131-123-162-133-79-63-151-42-181-34-54-177-184-160-193-41-115-176-32-178-3-106-167-80-51-118-139-191-46-141-9-62"
167,98399,100,44647,143046,19,"116-115-139-0-143-183-185-40-145-78-82-101-154-70-127-123-42-41-159-193-22-18-108-69-165-90-81-196-2-87-97-63-80-151-133-79-16-171-175-113-31-32-49-117-93-36-140-68-46-60-176-94-152-178-106-172-129-92-57-55-52-128-148-59-181-34-54-30-48-160-43-105-137-23-186-62-9-144-21-14-102-51-166-184-177-10-190-4-112-135-180-53-86-75-44-120-1-121-162-65"
168,104299,100,51150,155449,16,"113-171-175-16-25-44-70-194-123-42-193-41-21-7-14-49-94-122-63-86-75-120-129-55-52-185-40-91-92-127-54-177-184-161-133-1-2-74-152-19-79-162-48-160-34-181-117-143-183-9-62-37-167-78-56-31-145-57-148-186-89-108-18-146-22-159-0-153-23-137-43-116-65-51-176-73-144-106-178-165-58-164-27-90-180-135-154-53-101-97-80-151-59-139-115-198-46-196-81-157"
169,99844,100,46963,146807,15,"43-42-181-72-74-125-52-164-21-143-117-93-0-183-89-55-57-92-69-108-18-22-159-193-41-139-198-46-115-59-118-137-23-186-144-14-145-78-31-196-81-90-165-40-185-152-99-63-79-122-94-124-80-176-51-65-116-105-47-135-70-127-166-160-48-54-184-148-49-178-106-1-101-86-75-44-120-25-62-9-146-34-30-177-10-123-162-133-180-154-53-97-2-129-113-175-171-16-182-151"
170,109877,100,52908,162785,15,"52-145-78-92-129-160-34-48-54-177-175-113-56-119-165-14-128-180-154-135-45-59-41-193-22-159-139-46-137-124-94-166-43-42-115-117-0-189-101-150-1-97-186-23-89-183-51-72-162-127-70-90-164-21-144-102-9-62-37-148-152-2-120-25-44-16-171-31-172-170-143-19-99-136-53-63-79-151-65-116-69-18-108-176-80-122-12-185-40-133-184-35-123-86-75-57-55-49-178-106"
171,106371,100,49931,156302,16,"159-22-18-117-143-153-183-21-164-165-57-135-123-127-70-75-120-25-171-88-16-44-184-160-54-34-181-139-0-89-23-137-176-80-79-154-180-158-86-101-152-111-148-9-62-55-52-196-169-119-40-185-92-129-125-63-133-162-47-131-24-130-178-138-14-49-144-155-186-42-43-105-175-113-56-85-31-78-2-151-65-116-51-106-90-27-81-145-1-100-53-59-115-46-94-97-189-122-41-193"
172,94641,100,41767,136408,17,"178-137-46-139-93-18-22-159-193-115-51-79-133-151-72-116-105-65-162-63-121-26-101-150-78-145-31-25-75-86-53-158-180-173-135-154-97-1-57-52-55-70-127-123-112-4-10-177-54-184-43-42-5-41-181-34-160-59-176-148-62-9-89-183-0-60-66-80-122-120-44-16-171-175-113-56-164-21-14-49-189-94-152-2-129-92-102-15-186-23-143-117-69-108-144-165-90-40-185-106"
173,89886,100,40582,130468,14,"51-176-80-94-167-106-185-40-81-196-179-92-129-57-55-178-138-14-3-148-137-68-41-193-159-146-181-42-65-135-70-127-123-149-131-43-184-160-69-18-108-21-90-27-165-52-2-152-86-180-53-154-162-116-5-96-115-139-198-16-171-175-56-113-31-145-78-44-120-75-101-1-97-19-79-63-133-151-46-0-143-183-89-144-49-9-62-186-23-59-112-4-190-10-177-54-34-22-93-117"
174,91135,100,38897,130032,20,"97-26-152-14-21-164-27-90-113-175-171-16-185-52-2-101-75-120-44-78-145-92-57-55-86-70-112-4-84-51-137-9-62-49-138-178-106-148-94-130-0-170-143-117-93-140-22-146-103-42-116-151-63-182-100-53-158-154-180-162-65-105-43-54-30-10-177-190-127-135-173-59-115-139-108-18-159-193-41-181-34-160-48-184-123-133-79-80-176-46-183-89-23-186-15-144-119-165-40-1"
175,94622,100,42252,136874,17,"33-53-180-135-127-112-84-184-160-34-181-123-162-133-79-80-137-23-89-186-62-9-121-86-75-120-44-25-92-129-87-154-70-4-10-190-177-28-43-42-193-159-41-115-116-65-59-176-128-55-57-152-26-97-145-78-2-1-101-16-175-171-113-56-40-185-165-27-90-81-31-194-54-30-48-144-14-32-106-178-52-49-183-143-0-68-139-103-146-22-18-108-117-46-51-151-63-94-124-148"
176,96737,100,43252,139989,18,"80-137-186-23-89-183-141-115-195-146-22-18-108-69-159-193-41-139-46-165-90-81-31-113-175-171-16-177-54-48-166-135-70-180-154-62-144-14-179-145-78-94-130-3-178-106-40-185-176-51-59-197-42-5-43-65-116-131-28-184-4-84-112-127-123-93-117-143-0-15-148-152-125-101-75-120-25-44-82-2-1-97-121-63-133-79-151-162-160-34-181-9-49-52-55-57-92-129-86-53"
177,104632,100,50522,155154,15,"138-32-176-46-0-143-137-92-145-78-115-193-41-159-22-34-54-177-184-160-42-35-112-4-94-49-14-144-148-122-80-79-63-182-1-2-129-179-196-174-7-164-81-31-175-113-171-16-75-86-53-154-135-6-180-136-52-55-23-186-21-95-27-107-90-40-152-97-99-51-59-116-65-43-151-133-106-178-167-162-24-123-120-44-25-37-62-9-89-183-117-18-108-139-127-70-101-57-185-165"
178,98785,100,47741,146526,16,"101-86-53-42-34-22-193-41-23-114-144-14-165-90-27-164-95-81-171-16-78-62-9-186-137-94-26-97-120-25-44-75-150-152-74-63-133-116-43-160-48-54-129-145-196-157-31-113-175-143-0-117-176-122-79-80-93-140-108-18-139-115-59-151-12-148-37-92-57-55-52-65-184-10-177-190-112-4-123-162-180-154-135-70-127-198-68-46-118-51-183-89-49-106-178-185-119-40-2-1"
179,100387,100,48675,149062,17,"133-2-120-75-101-86-135-70-127-123-162-51-143-0-46-103-34-160-42-167-55-52-138-14-144-93-140-117-183-89-49-178-106-185-179-145-78-31-56-113-175-171-16-44-80-176-116-43-48-54-65-148-62-9-23-186-12-94-182-53-158-154-180-99-21-164-27-90-165-40-184-177-4-112-189-19-1-97-26-181-146-22-199-18-69-108-137-92-57-129-152-63-79-115-139-193-159-41-59-151"
180,103118,100,46558,149676,17,"19-189-94-23-186-15-9-62-74-165-164-21-46-109-137-144-14-39-27-90-115-193-22-34-54-177-184-160-123-162-133-173-136-152-92-78-145-25-44-120-2-129-49-102-114-83-89-106-185-40-174-16-171-175-113-56-31-55-128-148-80-151-51-176-111-57-179-196-81-63-79-42-181-41-139-93-117-0-143-183-178-52-75-101-86-53-180-154-135-70-112-4-43-116-105-65-59-99-1-97"
181,97367,100,43976,141343,14,"152-2-120-31-56-175-113-171-16-10-177-54-48-63-185-40-90-165-138-14-144-49-102-178-106-52-55-53-70-135-176-137-186-23-68-139-46-9-62-57-129-80-51-109-162-127-123-47-158-180-154-43-181-22-199-18-108-69-193-41-59-151-79-133-116-42-5-96-115-141-66-0-117-143-183-89-65-112-4-84-11-184-160-34-146-159-191-148-92-145-78-25-44-75-86-101-1-97-94-189"
182,99358,100,47810,147168,15,"97-1-190-10-177-54-48-43-116-49-102-138-14-144-186-46-96-77-149-127-75-44-120-25-78-38-31-113-175-171-16-184-160-34-22-69-18-108-139-115-59-129-92-90-165-40-185-106-178-55-52-70-135-145-196-81-57-133-45-162-123-4-112-35-24-151-80-9-62-148-94-182-53-154-180-63-79-41-193-159-146-42-105-65-86-101-2-152-176-137-23-89-183-143-117-0-93-140-68-51"
183,96686,100,44672,141358,16,"65-116-105-41-193-115-59-133-154-53-180-136-114-64-15-9-106-185-40-90-27-164-46-5-42-43-78-31-113-81-196-75-70-135-123-177-54-146-22-159-139-148-165-39-14-144-62-49-178-52-55-145-171-175-16-44-25-120-2-1-101-86-97-19-63-80-176-0-117-93-108-69-18-140-51-151-162-149-131-166-184-160-34-181-68-143-89-183-137-94-130-186-23-124-152-129-92-57-79-47"
184,95612,100,43431,139043,15,"14-62-9-23-186-144-21-164-90-27-92-129-120-101-86-127-112-4-84-35-149-116-5-42-43-184-160-34-181-41-139-46-115-59-151-80-128-57-2-136-180-154-135-53-26-100-121-123-177-54-70-75-44-25-16-31-81-40-185-196-145-78-56-113-171-175-89-183-143-117-93-0-137-94-152-74-1-97-18-22-159-193-65-162-133-79-63-19-52-55-130-176-51-141-148-37-49-106-178-165"
185,97121,100,43140,140261,16,"106-178-49-62-114-115-110-139-46-153-0-108-18-93-117-143-183-89-186-23-137-66-51-109-118-151-102-14-165-39-65-116-42-43-149-70-6-135-154-86-129-92-57-63-122-79-180-53-94-128-179-145-16-171-175-113-78-152-74-26-100-80-176-148-9-144-21-164-7-27-90-40-185-52-55-59-41-193-22-34-160-184-84-112-123-127-162-133-38-56-31-1-97-120-44-75-101-2-196-81"
186,97162,100,44055,141217,15,"52-55-57-152-133-162-123-161-135-70-154-180-53-63-79-122-94-189-124-68-140-36-93-129-78-25-127-177-54-34-146-22-159-41-193-115-151-121-26-100-97-1-101-86-75-2-167-9-62-43-160-184-42-5-116-65-47-59-61-144-14-185-165-27-90-40-196-81-56-113-31-157-145-92-80-176-137-89-183-143-117-18-139-120-44-16-175-171-38-3-49-114-186-23-0-46-51-148-178-106"
187,94789,100,43329,138118,16,"48-54-133-136-100-26-121-63-79-131-116-65-148-102-14-144-62-9-49-178-106-52-129-2-53-180-154-158-86-101-1-97-80-146-22-18-143-183-89-23-137-151-123-112-84-184-195-159-193-5-77-127-70-135-162-72-59-115-141-51-176-94-124-152-55-57-92-120-75-156-4-190-177-10-25-44-16-175-171-113-31-81-40-90-165-185-145-78-43-42-160-34-181-41-139-68-93-117-0-46"
188,96624,100,44712,141336,18,"139-5-42-46-23-144-21-164-90-27-165-40-81-92-1-101-97-152-2-145-196-57-65-116-43-123-86-113-56-31-78-120-75-70-127-112-4-190-10-177-54-48-34-160-184-89-183-18-22-159-193-41-115-59-151-133-180-53-136-63-79-176-80-148-128-178-14-49-162-131-149-47-109-137-9-62-129-82-25-171-175-16-44-19-94-124-172-52-55-185-8-106-158-154-135-51-0-143-117-68"
189,93758,100,41848,135606,18,"92-129-57-106-178-143-0-183-89-23-137-94-152-2-120-44-78-145-31-56-85-113-175-171-16-75-101-1-52-165-90-27-81-196-119-40-185-97-70-127-123-162-151-176-66-109-51-68-36-93-140-117-21-7-164-14-144-193-41-79-63-26-86-53-182-180-154-135-194-59-197-115-139-46-62-9-49-148-80-133-112-4-84-131-47-65-116-43-184-177-10-54-160-34-22-108-18-159-181-42"
190,93382,100,40414,133796,16,"178-106-14-144-49-148-112-4-10-177-34-181-56-113-175-16-171-31-185-40-55-57-92-25-78-145-196-81-90-165-129-1-70-126-84-184-139-110-69-108-18-146-22-159-46-0-143-117-93-140-36-89-183-9-62-186-23-137-176-97-101-75-44-120-2-87-133-162-30-54-48-160-43-42-41-193-115-197-53-86-100-99-189-94-79-63-80-151-51-59-116-65-123-127-135-154-180-136-152-52"
191,98787,100,49320,148107,16,"117-143-183-89-23-101-75-86-53-154-135-180-185-40-165-27-90-7-164-21-14-2-1-97-152-74-167-57-52-55-18-22-146-84-4-112-131-65-72-94-178-106-145-31-78-184-48-54-177-10-190-195-159-49-144-137-118-59-116-41-193-115-46-51-80-63-79-70-127-160-34-181-93-140-110-139-42-43-35-123-120-44-25-16-171-175-113-56-81-196-92-129-133-162-151-176-148-62-9-0"
192,108449,100,56507,164956,15,"177-54-184-89-183-143-117-41-193-0-137-178-185-119-40-165-164-21-144-84-4-112-127-179-81-196-56-113-31-78-2-182-123-149-65-43-116-42-5-181-34-160-14-27-90-94-79-59-159-22-115-80-52-55-152-1-101-86-53-180-154-135-70-162-45-151-133-63-97-16-88-74-23-186-114-102-49-3-106-175-171-145-62-9-176-51-46-139-69-18-108-57-92-148-33-129-25-120-44-75"
193,102093,100,49736,151829,17,"3-178-128-124-94-180-154-53-52-165-90-81-196-171-16-75-10-177-54-30-48-34-160-181-42-92-129-46-115-193-41-139-0-117-93-159-22-49-119-40-185-106-65-116-47-105-43-184-112-86-101-1-97-125-152-2-82-25-44-120-19-189-63-79-151-59-51-183-143-108-18-69-62-9-148-137-23-89-186-144-14-179-168-145-78-175-113-31-57-55-133-162-123-127-135-80-176-21-7-164"
194,98737,100,46837,145574,17,"22-34-181-90-81-196-31-78-145-82-120-1-26-53-158-86-101-2-129-92-57-55-137-143-170-23-186-89-183-83-9-62-49-106-178-69-108-18-163-118-51-66-176-117-0-46-59-123-135-154-180-144-21-164-14-148-133-151-162-44-113-175-171-16-75-70-127-112-4-84-47-131-149-184-177-10-54-160-42-43-65-116-193-41-115-79-63-136-97-152-94-130-40-165-185-52-80-198-139-159"
195,94485,100,42076,136561,16,"159-193-180-53-154-162-195-22-146-34-54-160-42-41-139-183-89-144-14-165-40-119-185-128-79-133-10-177-184-43-116-51-176-80-122-63-94-148-62-9-49-178-106-55-52-179-169-145-78-44-25-31-56-196-81-90-164-21-138-57-92-129-2-152-59-197-151-100-26-86-101-75-120-16-171-175-113-137-46-68-117-0-143-153-19-97-1-99-135-4-84-112-127-70-123-24-65-115-108-18"
196,101227,100,47309,148536,15,"27-90-39-138-167-94-63-79-133-162-116-65-105-43-42-115-148-128-31-113-56-175-171-16-123-4-84-112-127-135-154-86-75-120-78-17-81-40-196-145-2-101-97-1-92-129-80-151-59-118-51-176-44-25-178-49-62-9-15-137-46-139-93-117-0-74-152-57-55-52-193-22-146-34-160-180-53-26-19-144-14-164-7-21-132-114-186-23-89-183-143-41-54-177-184-106-8-185-119-165"
197,92660,100,41681,134341,17,"160-34-146-22-18-108-89-178-106-52-55-92-57-1-154-70-135-180-53-86-16-171-175-0-93-140-117-143-183-144-164-90-27-165-138-14-9-148-151-10-190-156-127-133-79-80-176-137-23-46-115-116-59-149-65-77-105-43-42-159-193-41-139-51-122-94-124-152-2-129-82-78-145-185-40-49-62-15-186-114-64-31-113-56-25-44-120-75-101-97-63-162-123-184-48-54-177-4-112-84"
198,101620,100,43286,144906,13,"69-18-108-68-46-109-51-80-97-125-152-52-55-185-40-165-23-186-89-183-143-117-159-22-193-41-123-135-154-70-127-43-42-181-34-160-184-49-138-32-99-79-63-167-144-73-14-178-106-145-78-44-25-120-2-87-57-169-81-56-113-85-157-196-62-9-148-94-130-0-153-137-92-31-175-16-171-75-86-53-180-26-101-1-129-174-90-27-176-66-151-133-194-162-59-65-77-116-115-139"
199,103052,100,53354,156406,14,"94-80-151-162-131-116-65-26-101-1-97-115-193-41-59-44-25-16-78-145-23-89-46-139-76-137-176-51-24-84-112-4-190-10-177-75-2-152-181-42-43-120-92-40-185-196-31-56-171-175-113-81-27-90-165-106-124-148-14-7-164-21-186-114-62-144-9-135-70-127-184-54-48-34-192-160-123-154-86-53-180-133-79-63-55-52-57-129-22-159-18-108-93-117-0-143-183-49-178-167"
200,97331,100,45264,142595,16,"185-165-21-144-117-93-108-18-22-34-160-42-43-166-70-135-127-48-54-159-193-41-139-198-137-62-9-94-63-180-53-86-101-2-120-44-25-78-145-57-55-47-184-84-190-177-10-29-123-133-162-151-51-176-80-148-49-14-90-27-81-17-31-196-169-52-143-0-183-89-186-23-46-115-4-112-126-154-75-16-171-175-113-149-131-65-116-96-5-59-79-92-129-1-26-97-152-178-106-40"
