SolutionID,TotalCost,NumNodes,TotalDistance,ObjectiveFunction,TotalRunningTime,Cycle
1,53401,100,25207,78608,27,"180-176-194-166-86-185-94-47-148-20-140-183-95-128-62-18-55-34-189-155-184-170-152-53-84-3-15-145-168-195-13-70-132-188-169-6-147-10-133-178-191-51-134-139-182-11-33-29-109-0-138-25-121-112-131-90-122-135-102-63-38-27-1-156-42-198-54-193-164-117-31-73-136-175-78-91-61-36-177-5-190-80-45-142-21-8-104-144-111-35-124-143-106-81-153-89-127-163-103-113"
2,54991,100,25539,80530,22,"140-183-34-55-18-62-124-106-128-95-185-179-86-166-194-176-113-103-114-127-89-163-153-97-77-81-111-144-39-160-0-29-145-15-3-70-13-132-169-195-168-134-43-139-49-11-182-138-33-56-104-8-87-21-177-5-142-46-190-80-105-73-31-117-198-131-121-51-6-65-188-147-90-63-40-107-122-135-1-156-193-164-54-45-162-136-78-175-91-79-61-36-141-82-143-35-109-189-155-152"
3,53148,100,27834,80982,10,"36-61-21-82-8-104-177-5-78-175-45-136-190-80-73-164-54-31-193-156-27-38-16-1-198-117-151-131-135-102-63-40-107-122-133-10-191-90-125-121-25-182-33-144-160-49-29-13-195-168-145-3-152-183-140-34-155-70-169-134-51-147-6-188-139-11-138-0-109-35-111-153-113-194-103-127-89-163-106-124-130-95-20-60-148-47-94-179-185-86-166-176-128-55-18-62-143-81-77-141"
4,51623,100,25385,77008,13,"21-61-36-141-77-187-165-127-89-103-163-153-81-143-62-95-130-128-124-106-176-113-194-166-86-185-99-22-179-66-94-47-148-20-140-183-152-170-34-55-18-3-70-145-15-155-35-109-0-29-33-160-104-8-111-144-11-138-182-74-134-139-43-168-169-132-195-126-13-188-51-121-90-133-122-107-40-63-102-135-131-198-156-1-193-117-31-54-73-164-45-78-175-190-80-136-162-142-5-177"
5,53099,100,26408,79507,10,"36-61-91-141-97-77-81-143-153-187-163-89-127-114-103-113-194-166-176-86-179-66-154-94-47-148-20-28-149-140-199-183-18-62-95-130-22-99-185-128-124-106-55-34-152-170-0-35-145-3-70-161-13-126-188-6-147-169-168-195-132-15-155-109-11-33-29-160-111-87-21-82-104-8-144-138-25-182-139-134-74-118-51-191-90-107-40-63-102-135-122-131-121-117-54-31-190-80-5-177"
6,49184,100,22787,71971,17,"130-99-185-179-66-94-47-148-60-20-28-149-4-140-183-152-155-145-13-15-3-70-188-169-195-168-43-134-139-11-33-160-144-29-0-109-35-8-104-138-51-90-191-122-133-10-40-100-107-135-63-102-38-27-1-198-117-193-54-164-31-73-112-121-136-80-190-175-5-177-36-61-79-91-21-82-141-97-77-153-163-89-103-127-114-137-113-176-194-166-86-106-124-62-83-18-55-34-128-95"
7,52434,100,25253,77687,15,"175-78-5-177-36-61-91-141-77-81-111-82-8-104-56-29-155-152-4-149-28-20-60-94-47-148-179-194-176-163-103-113-166-86-99-130-185-95-55-18-140-183-174-170-34-62-106-124-0-109-35-160-144-33-11-49-139-182-138-25-158-121-131-125-191-71-147-6-169-70-15-3-132-188-126-13-145-195-168-43-134-74-118-51-90-133-10-122-135-107-40-63-38-1-198-117-31-54-190-80"
8,52148,100,26513,78661,17,"145-3-70-132-169-188-6-147-51-191-90-10-133-122-135-63-1-198-193-80-190-45-175-78-142-5-73-54-31-117-156-131-121-158-25-177-21-91-36-61-141-77-153-163-194-113-166-172-60-47-66-99-185-95-179-94-140-152-155-189-29-35-0-109-34-18-55-62-124-106-128-183-28-149-20-148-130-86-176-103-114-127-89-165-187-146-81-111-144-104-8-56-160-33-138-11-139-43-168-195"
9,53030,100,28159,81189,14,"35-109-0-29-145-13-195-168-139-33-160-144-104-177-5-78-175-45-80-190-73-164-31-193-136-54-117-198-1-27-16-38-102-135-63-40-107-133-122-90-51-131-121-158-25-21-82-8-111-77-81-113-103-137-114-127-89-163-153-141-36-61-138-11-134-6-188-132-169-70-3-15-155-152-140-20-60-47-148-94-99-185-95-55-18-183-9-130-179-194-180-143-128-62-106-124-176-166-86-34"
10,51796,100,24905,76701,9,"195-168-126-169-188-6-147-115-178-10-133-122-63-135-90-191-51-121-158-25-173-54-164-31-198-193-73-117-190-80-45-78-5-175-177-36-61-141-77-111-33-160-11-138-139-182-104-21-82-8-144-29-109-35-0-170-4-149-60-148-47-66-94-20-28-140-183-95-130-185-86-179-166-194-180-176-62-124-106-143-113-103-89-165-127-163-153-128-55-18-34-152-155-3-15-145-161-70-132-13"
11,51679,100,25302,76981,16,"80-190-136-73-164-31-54-193-117-198-151-173-45-5-177-25-121-51-125-191-90-131-1-63-135-122-133-147-134-6-65-188-169-13-195-145-70-3-155-184-152-183-140-28-20-60-148-47-94-179-185-130-95-18-124-86-128-62-55-34-189-15-132-168-11-139-182-33-138-160-109-29-0-35-111-77-97-153-163-89-103-113-194-176-166-106-143-159-81-104-144-8-82-21-141-61-36-142-175-78"
12,49910,100,23106,73016,13,"29-0-109-35-153-146-187-165-137-114-127-89-163-103-180-176-113-194-166-185-179-66-94-20-148-47-99-95-86-106-124-128-62-83-18-55-34-170-140-183-152-184-155-3-70-161-15-168-145-13-132-126-195-169-188-6-134-147-71-51-121-131-125-90-122-135-63-38-1-117-198-54-31-193-136-80-190-175-78-142-5-177-138-182-139-11-144-8-61-36-141-97-77-87-21-82-111-104-33-160"
13,53005,100,25814,78819,12,"36-61-91-141-77-82-111-41-14-81-153-163-89-127-137-114-103-180-176-113-194-166-179-185-86-106-124-0-29-49-139-134-51-98-118-138-182-11-33-104-8-144-160-39-109-35-18-62-55-140-28-60-20-47-94-66-148-99-95-130-9-183-152-155-3-15-145-13-168-195-132-70-188-169-147-90-135-122-63-1-117-54-198-131-121-112-31-164-136-80-190-193-73-5-142-78-175-45-25-177"
14,51613,100,24926,76539,12,"38-135-63-40-107-133-122-131-121-51-90-147-6-188-169-70-3-155-15-145-13-168-195-139-11-182-138-0-109-35-159-143-124-55-18-62-34-95-130-183-170-152-140-20-148-47-94-179-185-194-176-113-166-86-106-153-186-163-89-165-127-114-103-187-77-82-111-41-81-12-29-49-160-33-144-104-8-21-177-61-91-36-5-78-175-80-190-136-54-164-73-193-31-151-117-156-198-1-16-27"
15,51708,100,25045,76753,15,"0-12-111-82-87-21-8-104-56-144-160-33-138-11-139-168-195-13-169-132-188-6-134-118-121-131-32-135-63-40-122-90-51-112-73-31-193-117-198-27-38-1-54-136-190-80-5-175-78-177-36-141-77-163-127-89-165-187-153-81-159-143-106-128-124-18-62-34-55-86-166-176-113-103-114-194-179-66-94-60-47-148-20-185-95-130-183-140-152-155-161-70-3-145-15-189-69-29-109-35"
16,50649,100,25727,76376,28,"103-113-180-176-194-166-86-62-18-55-34-35-109-0-29-11-33-56-104-160-144-36-61-91-87-82-111-8-21-177-5-175-78-117-156-1-27-38-63-135-131-198-54-31-193-190-80-25-138-139-134-74-118-121-51-90-122-40-107-133-10-147-188-169-132-13-195-168-145-70-3-152-140-183-4-149-28-20-60-148-47-66-94-179-99-185-130-95-124-106-143-159-153-81-77-141-187-163-89-127"
17,51292,100,25708,77000,13,"198-117-193-31-54-73-190-80-175-78-142-5-36-61-21-82-8-138-182-139-11-33-160-111-81-77-187-165-127-137-26-194-106-124-143-153-163-89-103-114-113-176-180-166-172-179-86-185-95-130-140-28-148-60-47-66-94-20-183-62-18-55-34-152-155-109-35-0-29-145-13-132-3-189-15-70-161-169-195-168-188-6-147-133-40-107-122-135-63-38-27-1-131-125-90-191-51-98-121-112"
18,50121,100,23772,73893,20,"163-153-111-8-82-77-141-91-36-61-21-177-5-78-175-80-190-136-193-117-54-164-73-31-198-42-156-1-16-27-38-102-63-40-107-100-135-122-133-10-90-191-51-121-25-182-138-33-11-139-29-160-144-0-35-109-168-169-132-13-3-145-195-70-15-155-184-152-18-62-55-140-20-28-60-148-47-94-179-99-185-86-95-130-9-183-34-143-124-106-128-166-194-88-176-180-113-103-127-89"
19,52431,100,26437,78868,11,"62-18-34-155-145-15-3-70-161-169-132-188-134-85-6-147-133-10-90-51-121-131-122-40-107-63-102-135-1-38-27-198-117-193-164-54-31-73-190-80-45-175-78-142-5-123-25-177-36-61-141-153-81-77-82-8-144-104-138-11-139-13-195-168-33-160-111-29-0-109-35-159-143-86-185-179-66-148-47-60-140-152-183-28-20-94-95-194-176-89-163-127-114-103-113-180-88-166-106-124"
20,50679,100,25642,76321,14,"60-20-28-140-183-34-55-18-83-62-128-124-106-176-180-113-163-143-111-8-21-61-36-141-97-77-81-82-56-104-144-160-139-11-33-138-182-25-177-45-190-31-54-73-175-78-142-5-80-193-198-117-1-135-63-107-40-122-10-133-90-131-121-51-147-6-188-169-132-3-15-145-195-168-13-70-155-189-29-12-0-109-35-153-187-127-89-103-114-194-166-86-99-130-95-185-179-47-94-148"
21,55914,100,27826,83740,17,"135-122-90-191-51-121-118-74-25-177-5-136-73-164-31-54-198-30-156-42-27-38-16-197-1-117-193-80-190-45-78-175-36-61-21-8-82-91-141-77-187-127-163-113-103-89-166-86-130-95-185-179-176-194-94-148-47-60-28-59-20-199-149-4-140-183-55-35-39-109-138-182-144-104-160-0-12-111-81-153-143-124-106-62-18-34-3-70-15-145-139-11-33-29-168-195-169-147-133-63"
22,51797,100,24587,76384,14,"114-137-127-165-89-163-153-187-141-77-81-143-34-55-18-83-62-128-106-124-35-109-0-29-8-82-111-160-11-49-33-104-21-36-61-177-78-5-142-175-80-190-193-31-164-136-73-54-151-117-198-42-156-1-63-135-122-90-131-121-51-98-120-71-191-147-6-188-134-182-138-139-43-132-3-15-13-195-145-168-169-70-155-184-152-140-183-28-20-148-94-179-185-86-166-176-194-180-113-103"
23,51647,100,24929,76576,14,"86-166-194-176-180-113-103-89-163-153-111-8-104-33-11-182-138-139-134-71-191-51-90-122-131-121-25-21-82-81-77-97-141-91-79-61-36-177-5-142-78-175-45-80-190-73-54-31-193-117-1-198-42-156-16-27-38-102-135-63-133-10-147-6-188-169-168-195-145-70-15-3-183-130-95-185-179-66-94-47-60-20-148-28-149-140-152-53-170-55-34-18-109-29-35-0-62-124-143-106"
24,52667,100,26823,79490,18,"145-15-70-3-155-55-18-62-124-34-170-152-183-140-4-149-28-20-148-47-94-179-95-130-128-106-159-143-109-35-29-0-49-139-11-138-33-160-144-56-104-8-82-77-81-187-137-114-165-89-127-103-166-194-185-86-176-180-113-163-97-141-146-153-111-68-87-21-177-25-118-51-121-80-190-175-36-61-78-5-193-31-54-117-198-1-38-135-63-40-107-122-90-147-169-188-132-13-195-168"
25,49986,100,25697,75683,21,"104-8-21-82-111-144-29-160-33-11-139-168-195-13-169-188-132-145-15-70-3-155-34-55-18-109-0-35-143-106-124-62-95-130-99-179-94-47-20-148-28-149-152-170-183-140-9-185-86-166-137-114-194-176-180-113-103-127-89-163-153-81-77-141-61-36-177-25-5-45-142-78-175-80-136-190-73-198-156-27-38-16-1-54-31-193-117-121-51-90-122-63-135-40-107-133-147-134-182-138"
26,50839,100,23877,74716,16,"20-60-148-47-94-66-179-185-86-166-194-113-103-163-176-106-124-62-18-55-143-153-81-77-50-111-144-35-109-0-29-145-168-195-160-33-11-139-182-138-104-8-82-21-87-177-97-141-91-79-61-36-5-78-175-45-142-162-136-73-190-80-198-117-193-164-31-54-1-38-63-107-40-100-135-122-90-51-147-6-134-188-169-132-13-70-3-15-189-155-184-152-4-149-140-183-95-130-99-28"
27,51799,100,25144,76943,15,"103-113-194-166-86-185-95-99-22-179-66-94-47-148-60-20-28-140-183-18-55-34-35-29-109-0-160-33-8-104-25-54-117-198-156-1-38-63-135-131-178-10-133-44-122-51-121-90-191-147-6-195-13-168-145-15-189-155-3-70-188-169-126-132-43-11-139-182-138-111-82-87-21-177-78-45-190-80-136-193-73-31-5-175-36-91-61-141-77-97-153-81-159-143-62-124-106-176-163-89"
28,51239,100,25167,76406,12,"125-191-90-122-135-102-63-40-107-133-147-6-188-70-3-189-167-155-184-152-18-124-163-89-103-127-113-194-176-166-86-95-22-179-94-47-20-148-60-99-185-130-183-140-28-149-4-34-55-62-128-106-143-109-35-144-33-138-182-104-8-21-25-121-131-1-24-156-198-117-54-31-193-190-80-45-78-175-142-5-177-61-36-141-77-81-111-160-0-29-11-139-168-195-15-145-132-13-169-51"
29,49393,100,23030,72423,10,"163-89-127-114-103-113-176-194-166-86-106-124-62-18-34-55-95-130-185-179-94-47-148-60-20-140-183-152-155-189-70-3-15-145-13-126-132-188-169-65-6-147-134-182-138-104-21-82-111-144-8-160-33-11-43-195-168-29-0-109-35-139-74-118-98-51-191-90-122-10-133-40-107-63-102-135-38-27-1-198-117-121-112-73-164-54-31-193-190-80-78-175-5-177-36-61-141-97-77-153"
30,50278,100,23581,73859,14,"161-70-3-189-155-184-152-140-149-28-59-20-60-148-47-94-66-179-166-194-130-95-128-124-106-143-159-81-111-56-144-160-29-0-109-35-62-18-55-183-9-22-99-185-86-180-176-113-103-163-89-127-187-146-153-77-141-91-36-61-21-82-8-104-33-11-138-25-177-5-78-175-142-45-190-80-193-54-198-1-63-135-122-133-90-51-121-31-117-73-182-139-168-195-132-188-169-13-145-15"
31,52866,100,26284,79150,23,"138-182-74-134-132-169-188-6-147-178-10-133-122-90-51-112-198-193-136-80-162-190-45-175-78-5-73-54-31-117-156-1-27-38-63-135-131-121-25-177-21-91-61-36-141-77-81-111-35-8-82-87-104-56-144-160-33-49-29-0-109-18-55-34-95-185-86-166-194-163-103-113-176-89-153-159-143-106-124-62-130-148-94-47-140-183-20-28-149-152-155-189-15-145-3-70-195-168-139-11"
32,51303,100,25359,76662,15,"112-121-118-74-134-98-51-191-90-133-122-135-131-1-16-27-38-63-107-40-10-147-188-169-132-195-168-13-145-70-3-15-189-155-29-160-0-109-35-34-55-152-183-140-20-148-47-60-94-66-179-86-185-130-95-18-62-106-143-124-128-166-194-176-113-103-89-163-187-153-81-111-82-21-104-138-33-144-8-77-141-61-36-79-91-175-78-5-177-190-80-45-142-136-73-164-193-117-31-54"
33,53192,100,25783,78975,12,"29-0-35-109-155-184-152-140-28-20-148-94-179-185-130-95-183-174-55-18-34-62-124-153-81-143-159-106-86-166-194-114-113-180-176-103-127-89-163-165-187-77-141-91-61-79-36-177-78-175-198-1-117-54-31-73-164-193-136-162-190-80-45-5-25-158-121-51-131-38-63-135-122-133-10-191-90-147-134-145-15-70-161-3-13-195-126-6-132-169-188-43-168-139-182-11-138-160-33-8"
34,53730,100,27264,80994,13,"190-80-45-175-78-5-177-36-61-91-141-77-82-21-8-104-56-111-144-160-35-109-143-159-119-81-163-187-153-106-124-62-176-113-127-89-103-114-86-18-34-83-55-128-180-194-166-185-130-179-94-47-60-20-59-148-22-99-95-183-140-28-152-155-145-195-126-132-13-15-3-70-188-169-6-134-43-168-139-29-0-33-11-138-25-121-122-40-63-135-131-90-191-125-51-31-54-117-198-193"
35,51534,100,25581,77115,20,"21-61-36-141-97-77-81-153-187-165-137-114-113-26-127-89-163-103-180-176-194-166-86-179-94-60-148-47-185-95-62-18-55-34-183-140-20-28-149-4-152-184-155-3-70-145-168-195-13-132-188-169-43-134-6-147-71-51-125-191-90-122-40-63-135-117-193-54-31-164-73-190-80-175-78-5-177-182-11-138-25-121-118-139-144-160-111-82-104-33-49-29-0-109-143-159-106-124-35-8"
36,52014,100,25562,77576,15,"179-185-95-86-128-18-62-124-176-166-194-113-103-127-89-163-106-143-159-35-0-109-29-160-139-118-51-191-90-71-147-134-74-121-131-135-32-122-10-133-107-40-63-27-38-16-42-156-1-24-198-54-31-117-193-136-5-142-175-78-80-190-177-61-36-141-77-97-187-153-81-82-21-56-144-33-111-8-104-138-11-168-195-169-188-70-3-15-13-145-155-55-34-152-183-140-28-20-148-94"
37,50622,100,23065,73687,18,"91-141-97-77-153-81-50-82-21-8-104-144-111-0-109-35-143-124-128-106-163-89-127-103-113-176-194-166-86-185-179-94-47-148-20-140-183-55-18-62-34-29-160-33-138-139-11-182-118-51-147-6-65-188-169-70-3-15-145-195-168-13-132-134-191-90-121-131-63-40-107-133-122-135-102-27-16-38-1-156-198-117-164-54-193-31-142-175-78-136-73-80-190-162-45-5-177-36-61-79"
38,52449,100,26666,79115,14,"156-1-197-16-27-38-102-63-40-107-100-135-122-133-90-191-147-134-6-188-65-169-132-13-195-168-189-155-3-70-15-145-139-11-182-138-33-25-177-5-36-91-61-77-141-21-82-8-111-35-0-109-153-187-127-89-113-163-103-114-194-176-166-95-86-128-124-106-62-185-179-66-148-94-47-20-28-149-4-140-183-152-34-55-18-29-144-160-104-118-51-131-121-54-31-80-190-193-117-198"
39,52476,100,25934,78410,16,"5-177-104-144-160-33-49-138-182-118-98-121-131-135-122-90-51-147-6-188-169-132-126-13-3-70-161-15-145-168-195-43-134-139-11-29-0-109-35-153-163-103-127-114-113-194-166-179-185-130-18-83-62-55-34-155-184-152-140-20-28-183-95-99-60-148-47-94-86-124-106-180-176-137-165-89-187-141-77-97-81-159-143-111-8-82-21-61-36-175-78-45-80-190-193-54-198-117-31-73"
40,50543,100,24354,74897,19,"86-166-172-179-22-99-66-94-47-148-20-28-140-34-55-18-62-128-124-106-159-143-35-109-0-29-49-11-139-168-195-132-169-188-6-147-133-122-32-135-63-38-1-131-90-51-121-193-198-117-31-54-73-164-136-5-45-80-190-175-78-21-82-81-153-163-176-180-194-113-103-127-187-77-141-61-36-177-25-118-74-182-138-56-104-8-111-144-33-160-13-145-15-3-70-155-152-183-95-185"
41,53062,100,25706,78768,23,"113-103-89-127-165-163-187-153-77-141-5-45-142-78-175-80-190-136-73-164-117-193-198-156-131-191-125-51-90-135-122-133-10-107-40-63-38-1-54-31-19-112-121-25-177-91-36-61-21-82-8-111-33-160-29-13-132-169-188-3-161-70-189-184-170-34-0-109-35-144-104-182-138-11-139-168-195-145-15-155-152-28-140-183-99-179-185-130-95-18-55-62-124-106-143-180-176-194-166-86"
42,51102,100,24843,75945,15,"21-87-82-8-111-144-29-160-33-104-138-182-11-139-168-195-132-169-188-147-133-122-135-102-63-38-27-1-121-131-90-191-51-134-13-145-70-3-155-184-152-140-199-4-149-28-20-60-154-94-66-179-172-166-86-185-99-148-47-183-34-35-0-109-55-18-62-106-124-176-194-113-103-114-127-89-163-153-81-77-141-61-36-175-78-45-80-190-156-198-193-117-164-31-73-54-136-5-177-91"
43,50784,100,24142,74926,10,"194-176-180-113-103-114-127-89-163-106-128-124-143-159-153-81-77-111-0-35-109-29-11-33-160-144-56-104-8-82-21-61-36-177-5-175-80-190-193-164-31-54-73-117-198-42-156-1-38-135-63-40-107-10-178-133-122-90-51-98-118-121-25-138-182-139-168-134-85-71-147-188-132-6-169-13-15-195-145-3-70-155-34-62-18-55-152-140-183-20-47-94-60-148-95-130-99-185-86-166"
44,52104,100,24385,76489,13,"77-187-127-114-113-194-166-86-185-130-99-94-47-148-66-179-22-95-128-62-18-55-34-183-140-199-20-28-149-152-170-124-143-159-106-176-103-89-163-153-35-109-0-29-13-195-145-15-168-11-139-134-169-70-3-132-188-6-147-51-120-191-125-90-122-135-121-73-31-54-117-193-190-80-45-142-175-78-5-123-177-25-182-138-33-160-111-82-87-8-144-104-21-36-61-79-91-141-97-81"
45,50999,100,24041,75040,21,"142-175-78-36-61-141-77-81-153-187-163-89-127-103-113-194-180-176-166-86-95-185-128-124-34-18-55-62-94-66-47-148-23-60-20-199-183-140-149-28-4-152-155-3-15-145-70-132-169-188-6-126-13-195-168-139-11-49-29-12-0-109-160-33-138-104-144-8-82-111-35-106-143-21-177-45-80-190-136-54-73-31-117-198-193-164-156-1-27-38-63-102-135-122-90-121-51-118-25-5"
46,50416,100,24558,74974,10,"1-16-27-38-63-40-107-133-122-135-131-125-51-90-191-71-147-6-195-168-3-70-15-145-13-132-169-188-85-134-43-139-182-138-11-33-160-35-143-159-106-124-62-18-55-34-152-183-140-4-149-28-20-47-148-60-94-179-172-194-113-89-127-163-187-77-81-153-103-176-166-86-130-185-95-128-109-29-0-111-8-82-21-177-61-36-175-78-5-80-190-136-73-112-121-117-31-54-193-198"
47,51841,100,25063,76904,14,"5-78-175-45-80-190-193-31-54-117-198-156-1-121-131-51-120-71-191-90-122-135-63-100-40-107-133-10-178-147-188-169-13-168-195-29-109-0-35-143-34-55-170-189-15-145-132-70-3-155-152-28-149-4-140-183-18-62-124-106-86-185-148-47-94-179-166-113-194-180-176-103-89-127-165-163-187-153-77-111-8-144-160-82-87-21-61-141-91-104-56-49-138-33-139-11-182-25-177-36"
48,50587,100,24816,75403,18,"164-73-190-80-45-175-78-5-177-25-74-182-138-33-144-104-8-87-141-91-36-61-21-82-77-97-153-187-163-103-89-127-114-176-180-81-111-143-159-106-124-62-18-55-95-130-185-86-113-194-166-179-94-47-148-60-20-140-183-3-70-15-155-152-34-35-109-0-29-160-49-11-139-168-195-13-145-132-188-169-6-147-134-118-121-51-90-133-122-32-135-63-38-27-1-198-117-54-31-193"
49,55475,100,29552,85027,11,"159-106-124-62-128-176-180-88-194-113-103-114-127-89-163-187-146-153-81-77-97-141-21-82-104-33-13-155-152-140-149-28-20-148-94-179-166-86-185-95-183-55-18-34-170-189-109-35-0-11-138-182-43-195-139-134-6-168-118-51-147-169-188-132-15-3-70-145-29-160-56-8-5-54-193-73-112-121-131-122-90-133-107-40-63-135-1-198-117-31-80-190-78-175-36-177-25-144-111-143"
50,50560,100,25076,75636,17,"89-163-153-81-77-141-177-25-182-134-43-139-11-138-160-33-0-29-145-3-70-13-195-168-169-132-188-6-147-122-135-131-117-1-38-27-63-100-40-107-133-90-121-54-193-31-73-164-136-80-190-78-175-5-36-61-21-8-111-35-109-143-106-124-83-62-128-86-95-185-99-130-9-199-140-183-18-55-34-184-189-155-170-152-4-149-28-59-20-60-148-47-94-179-166-194-176-113-103-127"
51,53525,100,27142,80667,16,"117-193-31-54-73-136-190-80-175-78-5-177-21-61-36-91-141-77-82-8-56-104-11-29-139-182-138-33-144-111-35-109-0-160-159-62-18-55-83-86-64-106-124-103-113-194-176-163-153-81-143-34-170-183-140-199-148-47-20-22-99-60-94-66-179-172-166-185-128-95-130-28-149-152-184-155-3-70-145-168-195-169-132-188-6-147-90-122-133-107-40-100-63-135-38-1-121-131-156-198"
52,52683,100,24948,77631,14,"121-1-156-198-117-193-31-54-73-136-190-80-175-5-177-36-61-141-21-82-77-97-81-111-8-160-144-49-11-138-104-33-29-12-0-109-35-143-159-119-153-124-106-62-83-34-140-183-20-47-148-94-179-86-113-194-176-103-89-127-137-114-163-166-185-95-18-55-152-155-3-70-15-161-132-13-145-168-139-74-118-98-51-90-125-191-134-195-126-169-188-6-147-178-10-133-122-135-63-131"
53,50312,100,24905,75217,16,"1-27-38-63-135-122-90-51-71-147-134-6-188-169-13-132-3-70-15-145-195-168-139-11-33-104-8-82-21-111-35-0-29-109-189-184-155-170-34-55-152-4-149-183-140-28-20-60-148-130-95-99-179-172-47-94-66-185-86-128-62-18-143-159-106-124-163-103-89-113-194-176-180-166-114-127-153-187-81-77-141-91-61-36-177-5-78-175-190-80-121-158-25-73-54-31-193-117-198-156"
54,51965,100,25864,77829,13,"8-82-77-81-153-187-163-103-89-165-127-114-113-176-194-166-86-106-124-62-18-95-99-130-185-179-94-148-20-28-140-183-55-34-152-170-189-184-155-3-70-161-132-6-134-168-169-188-13-195-145-15-109-0-35-143-111-39-29-160-104-144-33-11-182-25-121-73-54-31-193-117-198-156-1-38-63-40-90-125-131-135-122-133-10-147-71-51-118-139-138-177-5-78-175-36-61-91-141-21"
55,53364,100,27061,80425,11,"55-18-83-62-124-128-86-185-95-20-148-47-94-179-172-52-166-194-176-180-113-163-89-127-103-114-137-165-187-153-77-97-141-36-61-91-82-160-109-145-15-3-70-169-132-13-188-147-90-191-51-112-136-80-190-31-54-198-38-63-135-122-121-131-1-117-193-73-142-45-175-78-5-25-177-21-8-111-143-106-159-35-0-29-195-168-134-118-74-182-138-104-33-11-139-155-152-183-140-34"
56,52249,100,26986,79235,20,"145-15-70-3-155-184-152-34-55-183-199-140-28-149-20-148-60-47-94-66-172-179-185-99-95-130-86-62-83-18-35-109-0-29-168-134-118-51-90-122-63-38-27-16-156-1-198-31-193-117-54-121-131-135-147-188-169-132-13-195-139-11-182-138-104-21-61-36-141-77-153-89-127-103-163-114-113-194-176-166-124-143-106-159-81-111-8-82-78-175-142-45-80-190-136-5-177-25-33-160"
57,52008,100,25982,77990,17,"134-139-11-168-29-0-109-35-111-8-82-21-87-104-144-160-33-138-182-25-158-121-90-191-51-147-133-122-63-135-131-151-198-156-1-117-54-31-193-136-190-80-175-78-5-177-61-36-91-141-77-97-81-176-185-179-86-95-194-166-180-113-114-137-127-165-187-153-26-89-103-163-129-106-159-143-18-62-34-55-124-128-183-140-94-47-148-20-28-152-155-145-195-13-15-3-70-169-188-6"
58,51328,100,23697,75025,19,"153-187-163-89-103-113-176-194-166-86-95-130-185-94-47-148-20-28-4-149-140-183-170-152-18-143-159-124-106-62-55-34-0-109-35-111-82-21-8-56-144-160-104-182-74-118-134-139-138-33-11-49-29-189-184-155-3-70-132-13-145-195-168-169-188-147-71-120-191-90-133-122-32-135-63-38-27-1-117-198-193-151-131-51-121-112-73-31-54-80-190-175-5-177-36-61-91-141-77-81"
59,49844,100,24817,74661,11,"103-113-176-194-166-86-185-95-99-22-179-47-66-94-60-148-20-28-140-183-106-124-62-18-55-34-152-155-3-15-70-145-189-35-109-0-29-160-33-11-13-169-132-195-168-139-134-188-6-147-133-10-178-90-191-51-121-116-118-98-131-135-122-40-63-38-27-1-117-198-73-193-164-31-54-80-190-175-78-5-177-36-61-21-82-144-182-138-104-8-111-81-77-141-187-153-163-89-165-127"
60,49653,100,23834,73487,19,"160-33-138-25-158-112-121-131-125-90-191-51-147-10-133-107-40-63-102-96-122-32-135-38-27-16-1-198-117-31-54-193-190-80-175-78-5-177-36-61-91-21-8-82-111-144-29-0-109-35-34-183-95-185-86-194-114-127-103-89-163-153-187-141-77-81-159-143-124-62-18-55-106-176-113-166-179-94-47-148-20-28-149-140-152-155-15-145-3-70-132-169-188-6-126-13-195-168-139-11"
61,51332,100,24199,75531,15,"148-47-94-66-172-179-185-99-130-95-124-106-86-194-113-176-166-114-137-127-103-163-89-165-187-97-77-81-153-141-61-36-78-175-80-190-105-193-117-156-198-1-135-102-63-122-10-133-90-51-121-112-73-54-31-164-136-45-5-177-21-82-8-104-160-29-155-3-70-15-145-132-161-13-195-168-126-169-65-188-6-134-139-11-35-0-109-33-111-159-143-18-62-55-152-34-183-140-28-20"
62,52794,100,25864,78658,14,"31-54-193-117-198-156-1-16-27-38-63-135-122-147-85-134-169-188-6-132-70-3-15-155-109-35-143-86-176-113-127-103-163-124-106-128-62-55-34-83-18-95-140-152-183-20-148-47-94-179-99-185-166-194-89-153-81-97-77-141-91-61-5-142-45-162-175-78-36-177-21-8-111-144-160-104-0-29-145-13-195-168-43-139-11-33-138-182-118-98-51-90-131-121-112-136-80-190-73-164"
63,52016,100,25723,77739,12,"11-29-0-109-35-34-55-152-28-20-148-47-94-66-179-176-194-166-113-103-163-127-89-165-187-141-77-81-153-86-185-130-95-140-183-18-62-124-106-143-111-144-160-33-8-104-138-177-36-61-21-82-87-5-45-142-175-78-80-190-136-73-193-31-198-117-54-156-1-131-125-191-90-122-135-63-38-27-121-51-118-74-134-132-13-15-3-70-161-168-195-145-155-189-169-6-188-126-43-139"
64,54269,100,24432,78701,13,"0-35-109-29-49-11-139-74-118-134-168-195-13-188-169-132-145-70-3-155-152-183-140-94-47-148-20-28-149-4-53-170-34-18-83-55-124-143-159-106-128-62-86-95-130-185-166-113-176-163-187-97-77-81-14-41-153-146-141-36-61-8-82-21-177-45-175-78-142-190-80-73-164-31-117-193-54-173-5-136-198-1-38-63-122-32-135-90-191-51-121-158-25-182-138-33-160-144-104-111"
65,52332,100,25566,77898,16,"3-70-188-6-169-132-195-168-139-11-182-138-33-104-177-25-121-112-19-54-193-156-24-1-131-122-90-191-51-147-10-133-107-40-100-63-135-38-27-198-117-31-73-136-190-80-175-78-45-5-142-7-36-61-91-77-97-141-21-82-8-144-160-29-109-35-0-111-153-113-103-89-163-124-143-159-106-62-18-55-185-86-176-166-194-179-95-183-149-28-60-20-148-94-47-9-140-152-184-155"
66,53664,100,27451,81115,16,"81-77-141-36-78-175-142-5-177-8-104-144-139-168-169-132-13-195-145-189-155-15-3-70-6-188-147-10-133-40-107-122-135-1-16-27-38-63-102-131-121-198-117-31-80-190-193-54-73-51-90-191-71-134-74-98-118-182-138-11-49-33-160-29-0-109-35-170-28-199-152-4-149-140-183-20-60-47-148-94-179-185-130-95-62-34-55-18-86-166-194-176-103-127-113-106-124-89-163-153"
67,51394,100,25912,77306,11,"132-169-188-6-147-10-133-178-191-90-120-51-125-122-100-107-40-135-63-1-117-54-31-193-198-131-121-45-5-80-190-136-25-21-61-36-78-175-142-177-82-8-111-41-81-141-77-153-187-165-127-114-166-194-180-176-113-103-89-163-106-143-124-62-18-55-183-95-130-86-185-179-94-47-148-60-20-140-152-34-35-109-0-29-33-160-144-56-104-138-11-168-195-145-155-189-3-15-70-13"
68,50598,100,25525,76123,12,"177-5-78-175-142-45-80-190-73-54-31-193-117-198-156-1-27-38-63-107-40-133-122-135-90-191-51-121-112-131-125-147-6-134-139-182-138-11-29-111-81-77-141-97-187-114-194-113-103-89-127-165-163-153-143-86-95-183-140-149-28-94-60-20-148-47-179-185-166-176-180-106-124-62-18-55-152-155-15-3-70-188-169-168-195-13-145-189-69-109-35-0-160-33-104-8-21-36-61-91"
69,49637,100,23169,72806,24,"138-33-160-104-8-21-82-111-81-153-186-163-89-103-114-137-127-165-187-77-141-36-61-177-5-78-175-45-80-190-193-117-73-54-31-198-156-1-27-38-131-121-125-51-191-90-122-32-135-63-100-40-107-133-10-147-6-188-169-132-70-3-155-184-34-170-152-183-95-99-130-9-140-20-148-47-94-179-172-52-166-194-176-180-113-185-86-128-62-18-55-124-106-35-109-0-29-168-139-11"
70,51523,100,24983,76506,9,"187-153-81-77-82-87-21-91-141-61-36-177-5-175-78-45-136-73-190-80-31-54-193-117-198-156-1-135-102-63-122-125-51-90-191-147-188-169-70-145-13-195-168-11-160-33-144-111-56-8-104-138-182-25-158-121-139-0-29-15-3-155-35-109-159-143-106-124-62-18-55-152-140-149-28-183-9-95-185-99-130-22-66-94-60-148-20-47-179-86-180-176-166-194-113-103-114-127-163-89"
71,49424,100,24339,73763,17,"0-109-35-111-8-82-61-36-91-141-77-81-153-187-165-127-137-114-103-89-163-113-176-194-166-185-179-94-148-47-60-20-140-183-95-130-86-128-124-106-159-143-55-62-83-18-34-170-152-184-155-189-15-13-132-145-3-70-161-168-195-169-6-188-134-147-191-90-51-122-10-133-40-107-63-27-38-1-135-131-121-117-31-80-190-175-78-5-45-162-142-177-21-104-138-11-33-144-160-29"
72,51355,100,24935,76290,10,"15-145-29-0-109-35-34-55-18-62-124-143-159-106-86-95-130-99-183-140-149-28-60-20-148-47-94-179-185-194-166-176-180-163-127-114-113-103-89-153-81-77-87-21-104-138-182-33-144-111-160-56-8-82-141-61-36-78-190-80-45-142-175-177-5-25-158-121-112-19-73-54-31-193-117-1-135-131-90-122-63-40-107-133-147-51-98-118-74-134-139-11-168-195-132-169-188-70-3-13"
73,49084,100,22300,71384,17,"153-163-89-127-103-113-176-194-166-86-95-130-185-179-94-47-148-20-28-149-140-183-152-34-55-18-83-62-124-128-106-143-81-77-82-87-21-8-111-0-35-109-29-139-168-195-126-13-161-70-3-15-145-132-169-188-6-147-71-51-125-191-90-10-133-40-107-63-122-135-38-27-1-117-54-31-164-193-136-190-80-73-112-121-138-11-160-33-104-25-123-78-175-45-142-5-177-36-61-141"
74,53051,100,26480,79531,15,"86-95-130-185-179-94-47-148-20-183-140-152-189-145-13-195-168-11-139-138-33-182-25-177-21-8-104-160-144-111-81-153-77-141-61-36-5-78-142-175-45-80-190-164-54-31-151-1-38-135-27-16-156-117-193-105-136-73-198-131-121-116-118-74-98-51-90-10-133-40-107-63-122-147-132-169-6-188-15-70-3-155-62-55-18-34-29-109-0-35-106-176-113-103-89-127-137-114-194-166"
75,50938,100,24089,75027,17,"78-5-36-61-141-77-81-153-163-89-103-113-176-194-166-86-185-179-66-94-148-60-47-99-22-95-130-9-183-199-20-28-149-140-170-152-155-189-15-3-70-169-132-195-168-13-145-34-18-55-62-106-124-109-35-0-12-29-49-33-8-111-144-160-104-138-182-11-139-134-191-90-51-147-188-6-133-10-122-63-135-38-27-1-156-131-121-117-198-193-164-54-31-73-136-162-80-190-45-175"
76,51628,100,24882,76510,10,"106-124-62-18-55-34-143-153-81-97-141-77-8-82-21-61-91-36-177-5-78-175-142-45-80-190-136-193-117-54-31-73-121-158-25-138-182-51-125-131-38-27-1-135-10-133-72-107-100-40-63-122-90-191-71-120-147-188-6-169-132-13-195-168-145-70-3-15-139-11-33-160-35-29-0-109-152-140-183-199-149-4-28-59-20-94-47-60-148-130-95-185-179-86-166-194-113-163-103-176"
77,51968,100,26314,78282,15,"78-175-80-190-73-54-31-193-117-198-156-1-27-38-135-131-121-51-90-100-107-40-63-96-122-133-10-147-188-169-132-13-126-195-168-160-144-56-104-33-138-25-182-139-11-0-29-109-35-189-145-15-70-3-155-152-28-149-140-183-60-148-130-95-106-143-124-166-86-185-99-179-94-47-20-18-62-128-103-163-89-165-127-137-26-114-194-113-176-153-77-81-111-8-21-61-36-177-5-142"
78,53311,100,26612,79923,9,"6-147-134-98-51-125-191-90-122-40-63-135-1-27-16-38-156-198-117-193-136-80-190-45-142-78-175-36-177-5-73-31-54-121-118-74-182-138-104-56-8-82-77-153-81-111-29-0-109-35-144-160-11-33-139-188-169-70-161-15-3-184-155-152-185-99-183-140-28-20-60-148-47-94-179-166-113-163-89-127-103-114-194-176-62-34-130-95-86-106-124-55-18-189-145-13-132-195-126-168"
79,49938,100,24467,74405,12,"109-29-160-33-11-138-182-139-43-168-13-195-189-34-18-55-62-128-124-95-185-86-114-103-163-89-127-137-113-194-176-166-179-22-99-60-148-47-66-94-20-28-149-4-140-183-170-152-155-15-3-70-161-145-132-169-188-6-147-90-51-121-122-10-133-63-135-1-54-73-31-193-117-136-80-190-5-45-175-78-142-177-82-87-21-36-61-91-141-97-77-153-106-143-111-8-104-144-0-35"
80,49465,100,21984,71449,18,"135-63-102-38-27-1-24-156-198-117-54-31-193-164-73-80-190-45-5-78-175-36-61-91-141-97-77-21-82-8-177-25-74-139-11-138-182-104-160-33-144-111-159-124-106-143-153-187-165-163-89-127-114-103-26-113-176-194-166-86-185-130-95-99-47-66-94-60-148-20-149-28-140-183-34-55-18-62-109-35-0-29-168-195-145-15-3-70-13-126-132-169-65-188-6-51-121-131-90-122"
81,52786,100,26009,78795,11,"135-38-1-198-117-54-31-193-190-80-175-78-5-177-36-61-91-141-97-77-81-187-165-127-89-153-163-103-114-180-176-113-194-88-166-86-179-99-185-95-183-140-148-20-28-149-4-152-155-3-70-132-126-195-168-13-6-134-51-191-90-131-121-118-74-182-138-139-49-160-33-11-109-35-0-124-106-111-144-56-104-8-82-29-62-18-55-34-15-145-169-188-147-10-40-107-63-133-122-32"
82,51678,100,25136,76814,18,"40-63-38-27-1-24-156-198-117-193-31-54-73-190-80-175-78-5-36-61-141-77-153-81-82-21-177-25-121-125-120-51-118-74-182-11-33-56-8-104-138-139-160-144-111-35-0-29-109-195-168-13-145-155-183-130-95-86-106-124-62-18-34-55-143-163-113-103-127-89-114-176-194-166-185-99-179-94-47-148-20-28-140-152-3-70-132-169-65-188-6-147-67-71-191-90-133-122-135-107"
83,50566,100,23526,74092,10,"21-8-104-144-111-143-35-109-0-29-160-33-11-138-182-25-158-121-131-1-117-54-31-164-73-193-198-156-42-16-27-38-102-63-135-122-90-125-51-191-71-120-147-6-188-13-169-132-195-168-145-70-3-155-184-152-55-18-124-106-62-34-170-140-20-47-148-94-66-99-130-183-95-179-185-86-194-166-113-176-89-114-103-127-163-187-153-77-141-61-36-5-78-175-142-162-80-190-45-177"
84,53649,100,26275,79924,21,"31-54-193-117-198-156-1-197-16-27-38-63-122-135-112-121-131-51-191-90-71-147-13-195-168-43-139-134-6-188-169-132-145-35-109-0-160-29-11-33-56-111-82-77-141-97-187-153-163-180-176-113-103-89-127-114-194-166-185-179-94-47-148-20-28-149-4-140-155-3-70-152-170-128-86-95-183-55-62-18-34-124-106-159-143-81-8-144-104-182-138-25-177-61-36-190-80-136-73-164"
85,49926,100,24563,74489,18,"104-33-11-168-139-138-25-177-5-175-78-80-190-136-73-54-31-193-198-117-1-38-135-63-40-107-72-10-133-122-191-90-131-121-51-71-147-188-169-132-145-195-13-15-70-3-155-35-109-0-29-160-111-153-165-127-114-194-176-143-106-124-62-95-183-174-55-18-34-170-152-140-4-149-28-20-60-148-47-94-66-172-179-185-130-99-86-166-180-113-163-103-89-187-97-141-77-82-21-8"
86,51498,100,24621,76119,12,"177-5-175-80-190-54-31-117-198-156-1-16-27-38-135-32-102-63-100-40-107-10-133-122-90-51-147-6-188-169-132-195-3-70-13-15-145-155-184-152-28-140-183-55-18-62-86-95-99-130-185-148-20-47-94-179-172-166-114-127-89-194-113-163-153-81-77-58-82-87-21-61-36-141-97-187-103-180-176-106-124-143-35-41-111-0-109-29-49-33-160-144-8-104-138-11-168-139-182-25"
87,51911,100,24512,76423,12,"109-0-12-29-160-33-104-8-77-141-91-61-36-78-175-162-46-80-190-136-73-117-1-156-198-16-27-38-135-63-122-90-191-51-131-121-112-19-151-31-54-193-164-45-5-177-25-182-134-6-132-169-188-139-138-11-168-195-70-3-15-13-145-155-152-140-199-60-20-149-28-4-183-95-130-55-34-18-62-128-86-179-66-94-47-148-185-166-176-113-89-103-127-163-187-153-106-124-143-35"
88,50047,100,23215,73262,18,"153-163-89-127-103-113-176-166-86-95-130-99-22-185-179-66-47-94-148-60-23-20-28-140-183-34-35-109-143-106-124-128-62-83-18-55-152-184-155-3-15-70-145-195-126-13-132-169-168-29-0-111-144-160-33-104-138-182-11-139-134-188-6-147-10-133-178-191-90-118-98-51-125-122-63-135-131-121-73-164-31-54-117-198-1-156-193-190-80-5-78-175-177-36-61-8-82-21-141-77"
89,49563,100,23428,72991,11,"114-103-113-180-176-88-194-166-185-179-66-94-47-148-20-130-95-86-128-124-106-143-111-29-109-0-35-18-62-55-140-149-28-183-34-170-152-155-189-145-15-3-70-161-132-13-195-168-134-85-43-169-6-188-192-147-10-133-107-40-63-131-121-90-122-135-1-198-117-193-31-54-73-80-190-175-78-142-45-5-177-138-139-11-33-160-104-8-21-61-36-141-77-81-153-146-187-163-89-127"
90,53470,100,25854,79324,11,"163-103-26-180-176-166-194-113-114-127-89-165-187-81-14-77-97-141-36-61-21-82-8-111-0-109-29-160-104-177-5-175-78-45-25-158-121-73-164-31-54-193-190-80-117-198-156-1-135-131-51-90-122-133-147-6-168-134-182-138-33-11-139-43-195-13-132-169-188-70-15-3-145-189-155-184-170-152-183-28-140-20-148-94-86-62-18-130-95-185-106-124-128-55-34-35-143-159-153-186"
91,51406,100,24444,75850,21,"47-148-20-28-140-183-95-106-124-62-18-55-34-152-184-155-3-70-161-132-126-168-195-13-145-15-189-29-0-109-35-160-33-138-182-49-139-11-104-144-82-21-141-61-36-5-142-78-175-80-190-73-54-122-133-90-51-191-71-147-6-169-188-43-134-121-131-16-27-38-102-96-63-135-1-198-117-193-31-136-45-177-8-111-77-81-153-163-89-165-127-114-103-113-176-166-86-185-179-94"
92,51128,100,25153,76281,13,"78-36-61-141-97-77-82-8-104-144-33-160-138-11-29-35-109-0-12-111-81-146-187-165-127-89-163-153-143-106-180-176-113-166-194-86-185-179-94-66-47-148-20-28-95-130-140-183-124-62-18-83-55-34-152-155-3-145-195-168-13-169-132-70-188-6-51-121-54-31-117-193-80-190-73-164-198-1-38-27-135-63-40-107-122-133-10-90-147-134-43-139-182-25-177-5-142-45-162-175"
93,51653,100,25278,76931,21,"5-175-80-190-193-31-54-117-198-1-135-63-122-133-90-51-131-121-112-158-25-177-21-82-160-33-29-0-111-8-104-138-182-11-139-168-43-74-118-85-134-6-188-169-132-13-195-145-15-70-3-189-184-155-170-152-35-109-106-124-143-128-62-18-34-55-95-166-86-22-185-179-66-94-47-148-20-140-28-183-130-99-194-103-113-180-176-137-114-127-89-163-153-81-77-97-141-91-61-36"
94,52278,100,25498,77776,18,"90-125-131-121-74-139-11-168-195-145-13-132-70-3-152-149-28-20-148-140-183-34-55-18-83-62-128-124-106-35-109-0-29-160-144-104-33-138-182-25-177-36-141-163-180-176-103-89-127-114-137-194-166-179-185-130-95-86-113-153-77-111-8-82-21-175-78-80-190-142-5-45-136-73-164-54-31-193-117-198-156-1-38-135-63-100-40-107-72-122-133-10-147-6-169-188-134-118-51-191"
95,50852,100,24079,74931,10,"36-61-141-77-81-153-163-165-127-137-114-89-103-113-176-194-166-86-185-179-22-99-94-47-148-140-183-152-55-34-62-18-124-106-143-35-109-29-145-15-3-0-160-144-111-82-87-21-8-104-11-33-138-182-139-6-188-169-132-70-13-195-168-134-118-51-120-71-147-10-122-63-40-107-133-191-90-125-131-121-135-27-38-117-198-1-24-156-54-164-73-31-193-80-190-45-78-175-5-177"
96,50491,100,23777,74268,21,"134-195-168-139-182-138-11-33-160-29-0-144-8-82-104-25-158-121-90-122-135-63-102-38-27-16-1-156-198-117-151-54-31-193-164-73-136-162-190-80-175-78-5-177-36-61-21-77-141-187-137-114-103-163-165-127-89-153-111-35-109-34-183-140-28-149-4-20-148-47-94-179-185-99-130-95-86-166-194-88-113-180-176-62-55-18-124-106-143-189-15-70-3-155-145-13-132-169-188-6"
97,51281,100,26558,77839,18,"95-130-185-99-94-47-148-60-20-28-149-140-183-170-34-18-55-83-62-124-106-86-176-113-194-166-172-179-137-114-127-163-143-35-29-160-0-109-111-82-8-33-138-11-139-168-145-189-155-184-152-15-3-70-13-132-169-188-6-134-90-125-191-10-133-147-51-121-135-122-40-107-63-38-1-117-54-193-31-190-80-175-78-5-177-61-36-91-21-141-77-81-153-187-165-89-103-26-180-128"
98,50340,100,24358,74698,13,"73-136-190-80-45-175-78-5-177-36-61-141-97-77-8-104-56-144-111-160-109-0-29-35-124-128-86-185-130-99-22-179-94-47-60-148-20-28-95-166-176-113-194-114-103-89-127-163-153-106-143-62-18-55-183-140-152-184-155-3-70-15-145-13-195-132-169-188-168-139-11-33-138-134-147-71-191-10-133-100-40-107-122-131-1-27-38-63-102-32-135-90-51-121-198-156-193-117-54-31"
99,50636,100,24342,74978,22,"107-122-133-10-178-147-191-90-121-51-98-118-74-134-6-188-169-132-13-195-168-145-15-70-3-152-140-183-62-124-106-143-109-35-0-29-144-8-82-77-141-97-187-165-163-176-103-127-89-114-113-194-166-86-95-185-179-94-47-148-20-28-34-55-18-128-153-81-111-104-160-11-139-138-33-21-177-5-78-175-80-190-193-117-54-164-31-73-151-198-156-27-38-1-131-32-135-63-100-40"
100,51156,100,25679,76835,19,"148-94-179-185-86-95-183-140-34-55-18-62-124-106-143-35-109-0-138-139-168-195-11-33-160-29-8-111-82-77-81-153-163-89-26-103-176-180-194-166-113-114-127-137-165-187-141-91-79-61-36-78-175-80-190-193-73-54-31-136-45-142-5-177-21-104-25-51-147-71-191-90-131-135-122-40-63-1-198-117-121-118-134-6-188-169-13-132-70-3-15-145-189-155-184-170-152-149-28-20"
101,52588,100,25724,78312,14,"82-77-81-153-187-163-89-127-103-113-176-166-86-185-179-94-47-148-60-20-140-183-55-159-143-62-18-128-106-124-170-152-34-35-111-29-0-109-189-184-155-70-3-15-145-168-195-132-65-188-169-126-13-6-134-147-122-63-135-38-27-1-54-198-156-117-151-112-121-90-51-118-139-11-138-33-160-144-8-104-25-73-31-193-190-80-136-162-45-5-177-78-142-175-91-61-79-36-141-21"
102,49186,100,23208,72394,18,"28-20-148-47-94-66-179-185-130-86-166-194-176-113-114-103-89-127-165-163-153-77-141-91-36-61-82-21-177-138-33-104-8-111-144-160-11-139-182-25-5-142-78-175-80-190-73-54-31-193-164-117-198-24-1-156-27-38-16-135-122-63-100-40-107-133-90-51-147-134-6-188-65-169-132-13-195-168-15-145-70-3-155-152-34-55-18-109-0-29-35-124-106-143-128-62-95-183-199-140"
103,49963,100,23116,73079,16,"51-125-90-191-71-147-6-188-169-132-134-118-74-182-138-33-160-11-139-168-195-13-145-70-3-155-184-152-170-34-55-183-140-149-28-59-20-148-60-94-47-179-185-86-130-95-18-124-62-128-106-143-35-109-29-0-144-8-111-81-77-153-113-194-176-166-114-89-165-127-103-163-187-141-61-36-177-5-175-190-80-193-31-73-54-117-198-24-1-156-16-27-38-63-135-122-131-121-116-98"
104,55971,100,27246,83217,11,"8-104-56-33-49-138-182-139-11-168-195-13-122-135-63-133-10-147-6-188-3-70-15-145-132-169-134-90-191-125-51-121-73-31-54-1-156-198-30-117-193-80-190-175-142-45-78-5-36-141-97-77-153-187-127-89-103-163-194-176-172-179-166-113-180-86-95-185-18-124-55-140-20-28-183-170-152-53-184-155-189-35-34-62-106-143-159-109-0-12-29-39-160-144-111-82-177-61-91-21"
105,49319,100,22564,71883,15,"11-139-168-195-145-15-3-70-169-188-6-147-191-90-125-121-112-19-131-51-10-133-44-122-100-40-107-72-63-102-135-38-1-156-198-117-54-31-193-73-136-190-80-5-175-78-177-25-138-182-104-21-82-141-36-61-91-8-111-77-81-153-163-89-103-127-114-176-113-194-166-185-86-95-130-99-47-94-148-20-28-140-183-152-53-170-34-55-18-62-124-106-143-159-35-0-109-160-29-33"
106,50208,100,23336,73544,13,"156-1-16-27-38-63-100-40-107-72-122-133-10-147-71-191-90-125-135-131-121-51-118-134-6-188-169-132-70-3-155-189-15-13-145-195-168-139-182-33-160-11-138-104-8-111-109-0-29-35-143-106-124-83-18-34-62-183-140-55-128-86-179-148-47-94-99-185-95-166-194-113-103-89-127-176-163-153-81-77-97-141-36-61-21-177-45-5-175-78-190-80-162-136-73-31-54-193-117-198"
107,50120,100,23975,74095,20,"193-190-80-45-142-175-78-5-177-36-61-91-21-87-82-81-77-141-187-153-143-106-124-62-83-18-34-55-95-86-185-176-163-165-103-89-127-114-113-194-166-179-94-148-20-28-4-149-199-140-183-152-155-3-70-13-169-188-132-195-168-145-35-109-33-144-104-8-111-0-29-160-138-11-139-43-134-6-147-51-90-191-10-133-122-63-135-16-27-38-1-198-117-31-54-112-121-131-151-73"
108,51098,100,24195,75293,11,"128-106-124-62-18-55-34-35-109-0-145-195-168-139-11-138-182-104-160-29-49-33-144-111-41-81-153-77-97-141-91-21-82-8-87-177-79-61-36-5-78-175-80-190-73-164-31-117-198-54-193-121-131-1-135-107-40-63-102-96-32-122-90-147-6-13-132-169-188-70-3-15-155-152-183-140-20-28-60-47-148-66-154-94-179-172-166-194-113-103-163-114-137-127-89-180-176-86-185-95"
109,50734,100,23575,74309,15,"82-21-104-8-111-35-109-0-29-160-33-144-138-182-11-139-168-195-13-145-189-152-170-34-18-55-83-62-106-128-124-143-153-187-163-165-127-89-103-114-113-176-180-194-88-166-86-185-95-130-179-66-47-94-148-20-28-140-199-183-155-3-15-70-132-188-169-6-178-10-133-147-51-98-118-116-121-131-90-122-135-63-102-38-27-1-117-73-31-54-164-193-190-80-5-177-36-141-77-81"
110,55372,100,26825,82197,13,"147-192-6-134-118-74-182-139-11-138-33-160-8-104-144-29-35-109-0-168-195-13-132-169-65-188-126-145-70-3-15-155-152-34-62-55-86-95-194-166-113-127-103-89-163-141-91-177-21-87-82-111-176-179-22-148-47-60-199-4-149-28-20-66-94-9-183-140-99-185-130-18-106-124-159-143-153-81-77-61-36-175-190-80-73-54-117-31-193-198-30-42-156-24-1-63-135-122-90-51"
111,49934,100,23178,73112,10,"66-179-22-99-130-95-185-86-166-194-176-113-103-127-89-163-153-141-36-61-21-5-78-175-190-80-73-54-193-121-158-25-182-138-33-160-0-109-35-29-11-139-134-169-13-145-189-155-15-70-3-132-195-168-126-188-6-147-71-51-191-90-122-135-63-38-1-156-198-117-31-136-177-56-104-144-8-82-77-81-106-124-143-62-128-83-55-18-34-170-152-174-183-140-149-28-20-148-47-94"
112,50230,100,25105,75335,15,"176-180-113-103-114-127-165-89-163-187-153-81-77-97-141-82-111-56-104-138-33-160-29-0-35-109-144-8-21-61-36-177-5-142-78-175-80-190-136-73-54-31-193-117-198-1-38-63-122-135-100-40-107-10-133-191-90-125-51-131-121-118-134-13-169-132-188-6-139-11-168-195-145-15-189-155-3-70-152-34-62-124-55-18-143-106-128-95-185-94-60-148-183-140-20-47-179-86-166-194"
113,52623,100,24126,76749,11,"91-79-61-36-177-5-78-175-45-80-190-193-164-73-54-31-151-156-198-117-1-16-27-38-63-135-122-90-51-147-6-132-70-3-145-169-188-195-168-43-139-11-29-160-33-138-144-109-0-35-124-128-18-62-86-99-95-34-55-170-184-189-155-53-152-183-140-28-20-60-148-47-66-22-179-172-57-94-130-185-194-166-103-113-176-106-143-159-153-81-77-97-111-56-104-8-82-87-21-141"
114,52603,100,26303,78906,18,"95-130-86-176-113-194-166-179-185-99-94-47-148-60-20-59-28-149-4-199-140-183-152-184-155-3-70-13-15-145-132-169-126-195-168-11-138-25-73-31-117-24-1-131-121-118-98-51-90-6-188-147-10-133-122-107-40-63-135-38-27-156-198-193-54-80-190-5-142-78-175-36-61-177-8-82-21-141-153-187-81-77-97-111-144-33-160-29-62-18-124-106-143-159-35-0-109-170-34-55"
115,52411,100,23961,76372,31,"169-132-126-168-195-13-161-70-3-15-145-109-29-0-35-143-77-97-141-91-79-21-87-82-8-81-153-128-86-185-183-140-20-28-149-152-170-34-55-18-83-62-124-106-166-194-176-180-113-103-127-89-163-187-111-160-182-138-139-11-33-144-56-104-177-61-36-175-78-5-80-190-117-54-73-31-193-198-1-121-131-135-38-27-63-100-40-107-133-10-122-90-191-125-51-98-118-134-6-188"
116,50616,100,24104,74720,11,"109-69-189-155-184-152-170-34-55-18-62-124-106-95-183-140-149-28-20-23-60-148-47-94-185-166-86-194-176-113-103-163-89-127-153-81-77-82-91-141-177-21-61-36-175-78-5-73-193-80-190-31-54-117-121-122-135-131-1-38-27-16-63-100-40-107-133-10-90-51-191-71-147-6-188-132-169-70-13-145-15-3-195-126-168-139-11-33-160-182-138-56-104-8-111-144-29-12-0-35"
117,52742,100,25935,78677,16,"179-172-66-94-47-148-60-20-28-149-140-183-152-3-70-145-169-188-6-147-90-131-135-122-63-1-198-117-31-80-190-193-54-73-121-25-177-5-175-36-61-91-141-82-104-56-87-21-144-33-138-139-132-13-195-168-11-160-29-111-8-77-97-187-89-114-137-165-127-103-163-153-81-119-159-35-109-0-143-176-88-26-180-113-194-166-86-128-106-124-83-62-18-55-34-130-95-185-99-22"
118,51276,100,25039,76315,14,"195-145-15-70-3-155-34-18-62-83-55-183-140-149-28-59-20-60-148-47-94-179-185-130-95-86-166-113-89-127-163-103-176-106-124-143-109-35-0-160-29-144-138-33-11-139-182-121-25-21-104-8-111-82-61-91-77-81-153-141-36-177-78-5-175-80-190-136-164-73-54-31-117-198-193-42-156-135-122-40-63-38-27-16-1-131-125-191-90-51-147-85-134-6-188-169-132-13-126-168"
119,53027,100,27401,80428,11,"66-57-172-179-99-185-95-176-180-113-103-163-89-127-114-194-166-86-124-62-83-55-170-34-18-128-106-143-159-41-111-35-0-109-29-33-49-160-144-8-77-81-153-187-141-36-5-175-190-80-136-25-182-11-138-104-177-73-31-54-193-117-198-1-131-122-135-63-40-107-147-6-169-132-188-15-3-70-13-139-191-90-121-51-134-168-195-145-155-152-149-28-183-140-199-20-148-47-60-94"
120,52301,100,26048,78349,17,"51-121-112-73-136-45-78-175-80-190-193-31-54-117-198-156-24-1-135-63-100-40-107-133-122-125-90-191-147-6-188-169-70-3-155-55-34-183-140-199-28-149-4-152-18-62-128-180-103-113-166-179-94-148-47-20-95-185-86-176-194-114-137-89-127-165-163-106-124-29-33-104-8-177-5-36-61-91-141-97-77-153-81-111-35-109-0-144-160-11-138-182-139-132-126-145-15-13-195-168"
121,53298,100,28043,81341,18,"175-78-142-5-177-36-61-21-104-8-82-111-144-160-33-11-0-29-195-132-126-145-189-155-170-152-185-179-166-113-176-194-89-127-114-103-165-163-187-153-141-77-81-143-124-62-83-18-55-140-183-4-149-20-28-60-94-47-148-99-130-95-86-106-35-109-34-184-15-3-70-13-168-139-138-25-131-135-122-10-133-147-6-169-188-134-90-51-121-54-164-73-31-193-117-198-156-1-190-80"
122,51286,100,25108,76394,17,"175-5-177-21-61-36-91-141-77-97-187-163-153-81-111-144-82-8-104-33-138-182-139-11-49-160-29-0-109-35-143-106-128-86-185-95-183-140-149-28-60-20-148-94-47-179-166-194-113-176-124-62-34-55-18-170-152-155-189-145-15-3-70-161-13-126-132-169-6-188-147-134-168-195-43-74-118-191-90-51-125-121-54-73-135-102-63-107-40-10-133-122-131-1-198-117-31-193-80-190"
123,48909,100,21561,70470,18,"94-47-148-20-28-149-4-140-183-130-95-128-106-124-62-18-55-34-152-155-189-70-3-15-145-13-195-132-169-188-6-147-71-191-121-112-19-54-151-164-73-136-5-78-175-45-80-190-31-193-117-198-1-156-16-38-27-135-63-107-40-133-122-90-125-51-134-168-109-35-0-12-29-11-138-33-160-104-8-21-36-61-141-77-81-153-163-89-127-103-113-180-166-194-176-86-185-99-22-179"
124,50163,100,24580,74743,18,"148-60-20-28-140-152-184-155-3-15-195-168-11-139-182-74-25-177-5-175-78-45-190-80-193-117-198-27-38-1-31-54-121-51-90-191-125-131-122-32-135-63-40-107-133-147-85-134-6-188-169-70-145-29-144-160-138-33-104-8-82-87-21-61-36-141-77-81-153-187-163-89-127-114-176-180-103-113-194-166-86-128-159-143-109-0-35-106-124-62-18-55-183-130-95-185-179-66-94-47"
125,49006,100,23109,72115,15,"36-61-141-97-77-82-8-111-144-33-104-138-160-0-109-35-124-143-106-81-153-187-163-89-127-103-113-176-194-166-179-66-94-47-148-60-20-28-140-183-130-95-185-86-128-62-18-55-34-170-152-184-155-3-70-169-188-168-195-13-145-29-11-139-182-25-158-121-118-98-51-90-191-120-71-147-10-133-122-135-63-40-107-100-38-1-156-42-117-198-54-31-73-193-190-80-78-175-5-177"
126,49752,100,24195,73947,22,"25-182-138-139-134-43-168-11-33-160-104-8-82-87-21-177-36-61-91-141-97-77-143-106-124-113-103-26-166-194-176-180-114-127-89-165-163-153-81-111-144-29-0-109-35-62-18-183-140-28-20-148-47-94-179-185-86-95-55-34-152-155-15-3-70-145-195-13-132-169-188-6-147-133-122-100-107-40-63-135-90-191-51-121-1-24-156-198-117-31-54-193-73-45-78-5-175-190-80-136"
127,53168,100,27022,80190,18,"31-54-73-190-80-78-175-5-177-36-61-91-141-21-82-77-187-127-103-176-86-130-95-143-159-81-153-163-124-128-106-18-62-55-34-170-184-155-152-140-183-199-4-149-28-20-148-60-23-47-94-66-179-185-99-166-113-194-109-0-144-138-25-121-51-134-49-160-33-104-8-35-29-145-15-3-70-161-169-132-13-126-195-168-11-139-182-43-188-6-147-90-122-135-63-38-27-1-117-193"
128,51344,100,24818,76162,16,"134-147-51-90-10-133-122-135-63-102-38-27-1-131-121-112-73-164-31-54-117-193-190-80-175-78-5-177-21-104-33-138-11-168-13-70-161-145-189-170-152-183-140-4-149-28-9-22-185-179-66-94-47-20-148-99-130-95-34-62-18-55-124-106-143-159-113-194-176-180-103-89-165-127-137-114-166-86-163-187-153-81-77-82-8-144-111-35-29-0-109-155-15-3-188-6-169-132-195-139"
129,52374,100,25989,78363,13,"73-54-31-193-117-198-1-112-25-118-74-98-51-121-131-125-90-133-107-40-63-102-135-122-147-6-188-169-132-126-13-168-70-15-3-145-195-139-182-138-11-33-104-56-144-29-160-111-35-0-109-170-34-62-83-18-55-152-20-28-140-183-9-66-94-47-148-99-179-166-176-163-103-153-77-141-187-127-89-113-86-185-130-95-106-124-143-82-8-21-61-36-177-5-78-175-45-80-190-136"
130,52895,100,24862,77757,26,"175-45-80-190-136-73-54-31-193-117-198-156-1-27-38-135-63-40-107-122-90-191-51-71-147-188-195-145-13-132-169-70-3-15-155-170-34-62-124-128-55-18-152-140-183-148-47-94-179-185-95-86-166-194-176-113-103-127-89-163-106-143-35-111-8-21-61-91-87-82-77-141-153-81-41-37-12-0-109-160-33-138-11-139-168-29-144-104-182-118-121-19-112-116-158-25-36-177-5-78"
131,52911,100,25519,78430,18,"62-83-18-55-34-170-155-70-3-15-145-132-169-65-188-6-134-147-178-10-133-122-90-121-131-135-63-38-1-198-117-54-31-190-80-45-5-175-78-177-25-158-51-98-118-139-182-138-11-29-195-13-126-168-33-56-104-144-160-111-8-82-21-36-61-141-77-81-146-187-127-89-163-153-159-119-143-35-0-109-128-176-180-194-113-166-185-179-94-148-60-47-20-140-152-183-95-86-106-124"
132,51450,100,23119,74569,15,"179-99-130-95-185-86-166-194-113-176-103-89-163-153-141-91-61-36-21-87-82-77-81-159-143-106-124-62-18-34-55-109-35-111-8-104-160-29-0-144-33-138-25-177-175-78-142-5-80-190-136-164-73-173-193-31-54-151-1-24-156-198-117-131-121-122-63-102-135-191-90-125-51-118-74-139-11-134-85-147-192-6-132-188-169-13-195-168-145-70-3-155-152-183-140-20-148-47-94-66"
133,52183,100,25403,77586,13,"191-51-121-198-117-193-54-31-73-136-190-80-175-78-5-177-33-160-82-21-61-36-91-141-97-77-153-62-18-34-55-183-140-28-149-152-184-155-109-12-29-0-35-124-95-148-20-60-47-94-66-179-185-86-176-103-163-113-194-166-106-143-159-81-111-8-144-104-138-11-139-43-168-195-13-145-15-70-3-188-169-147-178-115-10-133-72-40-107-100-63-38-27-1-156-131-122-32-135-90"
134,51160,100,24908,76068,13,"147-71-51-191-90-122-135-63-102-38-27-156-198-117-54-73-190-80-136-193-31-1-131-121-25-139-11-33-144-111-8-77-153-103-113-180-176-166-194-114-127-165-89-163-187-141-61-36-78-175-142-5-177-21-104-56-160-29-0-35-109-138-168-195-70-161-13-145-15-34-183-140-4-149-20-28-148-94-154-60-47-66-179-99-185-86-128-106-124-62-18-55-152-184-155-3-132-169-188-6"
135,53447,100,25793,79240,15,"198-117-193-31-54-73-190-80-5-25-158-121-90-191-71-147-134-6-188-169-145-15-3-70-161-13-168-139-11-33-160-104-8-21-177-61-36-141-97-77-81-153-143-159-111-35-119-106-124-62-95-130-60-20-149-28-140-199-148-47-94-179-185-194-180-176-113-26-163-165-127-137-114-89-103-166-86-128-18-55-183-170-152-34-109-0-12-29-132-195-138-182-74-118-51-122-135-63-38-1"
136,52338,100,26293,78631,8,"127-165-163-153-187-141-77-91-36-61-21-177-190-80-193-54-31-117-1-38-63-100-40-107-72-122-133-147-71-51-191-90-125-131-135-121-25-138-104-144-8-82-111-81-159-143-106-124-128-95-130-99-22-179-94-66-60-47-148-20-28-149-4-183-184-155-189-109-29-33-11-139-168-145-70-3-188-169-13-132-195-0-35-34-55-170-152-140-18-62-185-86-166-194-180-176-113-114-103-89"
137,51277,100,25719,76996,14,"121-158-25-138-33-160-144-104-111-35-0-109-29-139-11-168-195-126-15-149-28-20-148-47-94-66-179-185-130-99-140-183-152-155-3-70-169-6-188-132-13-145-34-18-62-124-106-143-159-81-153-103-166-95-86-176-194-113-114-137-127-89-163-187-141-77-82-8-21-61-36-177-5-78-175-45-73-54-164-31-136-80-190-193-117-198-1-27-38-63-102-135-122-133-90-191-71-147-51-131"
138,50868,100,24783,75651,18,"111-29-0-109-35-143-81-153-163-103-127-89-106-124-130-95-99-185-166-113-194-176-128-18-62-34-55-83-86-94-47-148-20-28-140-183-170-152-155-70-161-3-15-145-195-168-126-13-132-169-188-6-147-191-90-122-63-40-107-135-38-27-1-156-121-51-131-198-117-31-54-73-164-193-190-80-162-45-21-82-77-97-141-91-61-36-78-175-5-177-8-104-33-138-182-139-11-160-144-56"
139,53968,100,26290,80258,12,"124-106-143-153-186-163-180-176-166-194-113-103-89-127-165-187-141-77-81-111-82-8-104-160-29-11-139-138-25-73-117-198-156-1-151-54-193-31-80-190-175-5-78-36-61-177-121-135-122-90-191-125-51-118-182-56-144-33-0-35-109-34-170-189-15-132-13-6-188-65-169-168-195-145-3-70-155-184-152-140-20-28-149-66-94-60-148-47-99-179-22-185-95-86-183-55-62-128-83-18"
140,51426,100,25576,77002,12,"8-82-77-163-176-180-113-103-89-127-187-153-81-111-33-29-0-109-35-143-106-124-62-189-161-70-3-155-152-140-95-130-99-185-86-194-166-179-66-94-47-148-60-20-183-34-18-55-170-15-145-132-13-195-168-6-188-169-43-134-139-11-138-25-121-112-198-117-1-27-38-102-63-100-107-40-133-90-122-32-135-131-193-31-54-73-190-80-162-45-5-142-175-78-177-36-61-91-141-21"
141,52581,100,24257,76838,15,"114-103-113-180-176-88-194-166-86-128-62-18-55-34-83-185-179-130-95-99-22-60-148-47-94-66-20-28-149-140-183-152-170-184-155-3-15-13-161-70-169-6-188-118-121-131-125-90-191-120-51-74-139-182-138-77-141-82-8-177-5-142-78-175-45-162-80-190-136-54-117-31-73-193-198-1-135-63-122-133-147-134-132-195-145-168-11-33-104-144-160-29-35-109-0-124-106-163-89-127"
142,50418,100,25556,75974,12,"6-188-169-132-13-195-168-145-15-70-3-155-189-35-109-0-29-160-33-144-104-8-111-124-143-106-128-95-130-185-179-94-47-148-60-20-28-140-183-34-18-55-62-86-166-194-113-176-103-165-127-114-163-89-187-153-77-141-36-177-78-45-136-73-54-31-151-112-19-131-122-40-107-133-10-63-135-38-1-156-117-198-193-80-190-175-5-61-21-87-82-138-139-11-25-121-125-51-90-147"
143,52414,100,24020,76434,26,"56-104-160-33-138-182-11-139-74-118-98-51-85-134-188-6-147-191-125-90-133-122-107-40-63-135-1-156-198-117-193-54-31-73-136-80-190-19-112-121-25-177-5-142-175-78-36-61-21-87-82-8-68-111-159-143-124-106-77-97-141-81-153-163-103-127-89-114-176-113-180-128-34-55-62-18-86-194-166-185-179-94-148-20-183-140-152-184-155-3-70-132-169-168-195-29-35-109-0-144"
144,52153,100,26049,78202,16,"0-29-39-111-81-153-187-141-77-8-144-104-21-91-61-36-177-73-31-54-121-131-125-51-90-191-147-10-133-122-107-40-63-102-135-117-193-190-80-175-78-5-25-182-138-139-33-160-11-43-168-126-132-169-188-6-13-145-195-15-161-70-3-155-184-152-55-34-170-140-20-60-148-47-94-179-166-114-127-165-163-89-103-26-194-176-113-106-124-128-86-185-99-183-130-95-18-62-35-109"
145,50523,100,24121,74644,21,"194-176-180-113-103-89-127-165-163-153-81-111-8-82-77-141-91-79-61-36-177-5-78-175-142-45-80-190-136-193-31-54-73-117-198-1-38-135-63-122-133-40-107-90-191-98-118-116-121-51-147-6-134-43-139-138-11-168-195-188-169-132-13-3-15-70-145-33-160-29-189-155-109-0-35-143-106-124-62-18-55-152-34-128-130-95-86-179-22-185-99-140-183-20-60-23-148-47-94-166"
146,51217,100,26000,77217,17,"102-63-40-107-10-133-122-90-51-147-134-139-168-195-13-145-132-169-6-188-70-15-3-155-184-170-152-95-130-86-185-179-94-47-148-20-28-140-183-124-106-143-62-55-18-34-189-109-29-160-33-144-0-35-81-153-187-165-127-114-194-166-176-113-26-89-103-163-141-77-8-111-104-56-138-11-182-25-136-80-190-175-78-142-5-36-61-177-73-54-31-193-117-198-1-16-27-38-131-135"
147,52571,100,25306,77877,13,"73-164-193-31-54-151-117-198-42-156-1-16-27-38-135-32-102-63-100-40-107-122-10-133-147-191-90-125-131-121-51-118-134-139-11-160-144-104-82-8-35-111-187-163-113-176-194-166-86-185-179-47-94-66-154-60-148-20-140-183-34-18-128-106-153-141-77-97-81-143-124-62-55-152-155-3-70-15-145-132-13-169-188-195-168-109-29-0-33-138-177-36-5-45-142-175-78-80-190-136"
148,49707,100,24050,73757,14,"78-5-177-36-61-21-82-111-160-144-8-104-33-49-29-0-109-35-62-86-95-183-140-28-20-148-47-94-99-185-179-166-194-176-113-103-127-165-89-163-187-141-77-81-153-143-106-124-128-55-152-170-18-34-155-70-3-15-145-13-195-126-132-169-188-168-139-11-138-182-25-121-98-74-118-134-147-51-191-90-125-135-102-63-40-107-133-122-131-1-198-117-31-54-73-164-193-190-80-175"
149,50905,100,25885,76790,12,"95-130-185-94-47-148-60-20-28-140-183-152-155-3-70-188-6-147-90-122-107-40-63-135-1-38-27-156-193-31-54-164-136-45-78-175-142-162-5-177-21-104-8-82-81-153-163-103-113-176-86-166-194-114-137-89-127-187-97-77-141-61-36-91-25-73-80-190-117-198-151-112-121-51-169-132-13-145-195-168-139-11-33-138-182-160-29-35-109-0-12-144-111-143-106-124-62-34-55-18"
150,51949,100,25071,77020,16,"132-169-188-6-147-178-10-133-107-40-63-122-135-27-38-16-156-198-1-131-125-90-191-120-51-121-117-193-31-54-164-73-190-80-162-78-175-142-45-136-173-25-177-5-36-61-141-21-82-8-0-143-106-185-179-94-47-148-183-140-20-130-95-18-55-62-124-86-166-194-127-89-103-113-176-180-163-153-81-77-111-35-109-29-182-138-104-144-160-33-11-139-168-145-189-184-155-15-3-70"
151,50515,100,25055,75570,13,"163-89-103-114-137-127-165-187-146-153-159-143-35-109-29-160-144-33-11-139-182-138-104-8-56-111-41-81-97-141-77-82-21-36-61-177-5-78-175-198-1-38-63-135-54-31-73-80-190-193-117-121-131-107-40-133-122-125-51-90-191-147-6-15-3-70-188-169-132-13-195-168-145-0-106-128-124-62-18-55-34-152-183-140-4-149-28-59-20-60-148-47-94-179-185-86-166-194-176-113"
152,52861,100,26284,79145,9,"127-89-163-153-81-111-144-160-49-138-11-195-168-139-182-25-136-45-162-80-190-31-54-73-164-193-156-198-117-121-131-135-63-107-40-133-122-90-125-120-51-191-71-147-6-169-188-132-145-70-3-155-152-34-0-109-124-106-86-176-113-103-194-166-185-95-99-22-179-94-47-60-148-199-28-20-149-4-140-183-55-62-18-35-29-33-104-21-61-36-78-175-142-5-177-87-8-82-77-187"
153,52129,100,27279,79408,12,"122-90-125-131-121-51-118-182-138-11-168-195-13-145-15-70-6-188-169-132-3-155-109-29-0-35-152-28-149-20-148-179-86-95-99-47-60-94-66-22-185-124-62-18-55-34-140-183-128-106-143-144-21-82-8-104-160-33-111-180-176-194-166-113-103-163-89-127-165-187-153-81-77-141-61-36-177-54-117-193-164-31-73-78-175-5-45-190-80-198-1-16-27-38-135-63-40-107-10-133"
154,51762,100,25969,77731,20,"131-135-63-1-198-117-193-31-54-73-136-190-80-175-78-5-177-36-61-91-21-25-74-134-43-132-169-13-168-195-139-11-33-49-138-182-56-104-160-0-109-29-35-124-106-128-95-20-148-66-94-60-47-179-185-86-194-166-176-103-89-127-113-163-187-153-81-111-144-8-87-82-141-97-77-143-18-55-62-34-183-140-28-152-155-189-145-15-3-70-161-188-6-147-122-90-191-125-51-121"
155,51394,100,25444,76838,16,"51-191-90-122-135-32-100-107-40-63-38-1-156-54-31-117-198-193-136-162-175-142-5-45-190-80-78-177-104-144-8-21-61-36-141-77-81-159-143-106-179-185-47-94-148-23-60-20-28-183-140-130-86-194-113-166-176-180-114-127-89-103-163-153-111-0-109-55-95-128-124-62-18-34-152-184-155-189-35-29-160-33-138-11-139-43-168-195-145-15-3-70-132-169-188-6-147-134-118-121"
156,48831,100,23691,72522,13,"21-61-36-91-141-82-8-104-33-138-11-188-169-132-15-145-189-34-18-62-55-124-106-143-35-109-0-29-160-111-41-81-77-97-153-187-163-89-127-103-113-176-180-194-166-179-66-94-47-148-60-20-99-185-86-130-95-183-140-28-149-152-155-3-70-13-195-168-139-182-25-73-54-19-112-121-51-90-191-10-133-122-63-40-107-100-135-38-27-1-198-117-31-193-190-80-175-78-5-177"
157,51457,100,25233,76690,11,"11-139-168-195-145-15-3-70-169-188-6-147-51-191-90-125-131-135-122-133-107-40-63-1-24-156-198-117-54-193-164-73-31-151-19-112-121-25-182-138-104-8-144-111-82-21-61-78-175-190-80-45-5-177-36-141-187-153-77-81-143-62-18-95-185-94-148-47-20-28-149-4-152-170-55-34-183-140-130-99-176-113-103-89-163-127-194-166-179-86-128-106-124-35-109-0-12-160-33-29"
158,52827,100,26562,79389,18,"36-61-79-91-141-21-87-82-77-81-153-106-143-111-8-104-33-29-160-109-35-0-152-140-20-148-47-94-66-99-130-95-185-179-166-194-176-163-127-89-103-113-86-128-124-18-62-55-34-174-183-170-155-3-15-145-168-43-195-126-188-132-169-13-70-6-147-51-121-135-63-38-27-1-54-31-73-78-175-80-190-193-117-198-131-90-191-178-10-133-122-134-139-11-138-182-25-45-5-177"
159,52760,100,25482,78242,14,"113-176-86-95-62-18-55-34-124-106-143-153-187-146-97-81-77-141-91-61-36-79-177-25-142-175-78-5-45-80-190-136-193-73-31-54-198-117-156-1-38-63-133-10-178-191-125-90-122-135-121-51-147-6-188-13-161-70-3-15-145-132-169-195-168-11-43-134-139-182-8-82-21-87-104-138-160-49-33-144-111-109-35-0-29-155-152-183-140-94-179-185-99-47-148-20-60-66-166-194"
160,53753,100,25053,78806,7,"147-134-85-74-118-51-121-112-158-25-182-139-168-195-13-132-169-70-3-15-155-152-170-55-34-183-140-28-20-148-94-179-166-194-89-127-103-113-176-185-86-143-35-109-18-83-62-124-106-163-153-81-82-87-21-138-49-11-33-160-29-39-12-0-144-8-104-111-77-97-141-61-36-177-5-45-162-136-142-78-175-190-80-31-54-117-193-198-156-1-135-107-40-100-63-122-131-125-90-191"
161,50229,100,24725,74954,22,"90-191-125-51-182-138-8-82-21-5-175-78-142-45-80-190-136-73-31-54-164-193-117-198-156-1-131-121-25-177-61-36-141-77-81-124-18-62-55-140-183-95-106-159-143-153-163-103-127-89-165-137-114-176-113-194-166-86-179-47-94-66-185-99-60-148-20-28-152-184-155-189-0-109-35-29-160-33-139-11-13-145-15-3-70-168-195-132-169-188-6-147-133-107-40-63-102-32-135-122"
162,52214,100,23840,76054,13,"140-152-55-18-62-124-106-159-143-35-109-0-29-144-160-168-195-169-132-13-15-145-155-189-3-70-188-6-139-11-33-104-138-25-158-121-131-125-90-133-10-122-135-32-63-102-38-16-27-197-1-156-198-117-51-147-134-118-112-73-54-31-193-136-80-190-78-175-5-177-8-82-21-91-61-36-141-97-77-81-153-163-103-113-194-176-86-166-52-172-179-66-47-148-94-99-185-130-95-183"
163,54959,100,27416,82375,8,"190-31-54-117-198-156-24-1-16-27-38-135-102-63-40-107-10-115-191-90-131-121-118-98-51-122-133-178-147-188-195-18-55-170-155-3-70-145-168-169-132-13-15-109-29-144-104-160-33-138-8-111-0-35-34-152-28-20-47-94-148-140-183-185-86-130-95-83-62-128-113-103-26-194-172-179-166-176-163-89-127-114-106-124-143-159-153-81-77-21-82-141-91-61-36-5-142-78-175-80"
164,52256,100,26936,79192,10,"180-176-86-99-130-95-55-18-62-124-128-106-143-35-109-0-29-160-33-11-139-138-104-144-8-77-81-153-187-141-82-87-21-25-117-80-190-5-78-175-36-61-177-73-54-31-193-131-135-90-133-10-122-40-107-63-38-1-198-121-51-98-118-134-195-168-188-169-70-3-13-145-15-155-184-34-170-152-28-149-140-183-199-20-148-47-94-179-185-166-194-113-165-89-114-127-137-163-103-26"
165,49432,100,22765,72197,14,"148-47-94-179-166-194-176-113-26-114-137-127-165-89-103-163-187-141-61-36-177-5-78-175-190-80-193-31-73-54-117-198-1-27-38-102-63-32-135-122-133-10-191-90-51-121-158-25-138-11-139-6-188-169-168-13-195-145-70-3-15-155-152-170-184-34-62-35-109-0-29-160-49-33-104-144-8-82-77-153-81-41-111-143-106-124-128-83-18-55-95-86-185-130-183-140-28-20-23-60"
166,48019,100,21577,69596,11,"62-128-124-106-159-143-111-8-104-144-160-29-109-35-0-49-33-138-11-139-43-168-195-145-155-3-70-15-13-132-126-188-169-6-147-134-118-98-121-51-90-191-10-133-100-107-40-63-122-135-38-27-1-117-193-31-54-164-73-136-190-80-78-5-142-175-177-36-61-91-141-97-77-153-163-103-89-127-113-176-194-166-86-95-130-185-179-172-66-94-47-148-20-28-140-183-34-152-18-55"
167,51655,100,24425,76080,15,"36-61-79-91-141-97-77-153-187-163-89-127-137-114-103-113-180-194-166-185-86-176-128-106-143-124-62-18-95-130-99-22-179-148-94-66-47-20-140-183-152-170-189-145-15-70-3-155-109-35-0-144-111-39-29-160-33-138-11-139-168-195-13-132-169-188-6-5-78-175-45-190-80-193-198-156-1-117-31-54-73-16-27-38-63-135-122-133-90-191-51-118-98-121-158-25-177-104-8-21"
168,52371,100,24880,77251,13,"103-113-180-176-194-166-86-185-99-179-94-47-148-60-23-20-140-149-28-183-174-152-170-184-155-29-109-0-35-159-143-106-128-124-62-18-55-34-3-70-15-145-13-132-188-169-126-195-168-138-33-11-139-134-51-90-135-122-63-38-1-156-198-117-31-54-193-190-80-136-73-121-25-177-7-36-91-79-61-104-144-8-21-111-82-77-45-142-175-78-5-87-141-97-81-153-187-163-89-127"
169,50835,100,24082,74917,12,"122-133-10-147-71-120-51-191-90-131-121-25-82-21-8-104-160-33-11-138-182-139-43-134-6-188-169-126-168-195-13-132-70-3-145-15-189-155-184-152-170-29-12-0-109-35-143-106-128-62-95-185-86-179-94-47-60-148-20-28-149-140-183-55-18-34-124-81-153-163-113-176-194-103-89-77-141-36-61-91-177-5-78-175-80-190-73-164-193-31-54-117-1-38-135-63-40-107-100-72"
170,50863,100,24713,75576,11,"54-164-73-136-190-80-5-177-36-61-141-97-77-82-21-87-8-104-111-159-143-106-124-55-62-18-34-170-152-140-4-149-28-20-60-199-183-9-148-47-94-179-185-130-95-86-166-194-113-26-163-89-127-114-176-103-187-153-35-0-109-138-144-160-29-33-11-15-3-70-145-132-195-13-168-126-169-188-6-90-121-51-147-10-133-40-107-63-122-135-1-156-42-38-16-27-198-117-193-31"
171,53694,100,26120,79814,13,"104-8-21-82-77-97-81-111-144-33-160-29-0-109-35-34-55-18-62-183-140-28-20-148-94-179-185-95-86-128-124-106-176-127-89-103-113-163-153-187-141-61-36-78-175-142-45-162-5-177-25-112-19-151-73-190-80-136-193-31-54-117-198-156-1-38-135-90-125-121-131-122-100-107-63-40-133-10-178-147-6-98-51-13-132-169-145-15-70-3-188-134-74-118-43-168-195-11-139-138"
172,50696,100,23685,74381,14,"152-55-18-62-124-106-159-143-109-35-12-0-29-160-33-139-11-43-168-126-195-13-145-15-155-3-161-70-132-169-188-6-134-147-10-133-191-90-125-51-121-112-131-135-122-40-63-38-1-156-42-198-117-193-80-190-54-31-73-136-175-45-142-78-5-177-25-182-138-56-104-144-111-8-61-36-141-77-82-21-81-153-163-89-103-176-113-194-166-179-99-185-86-95-183-148-47-20-28-140"
173,50662,100,24409,75071,19,"98-118-182-138-104-144-33-160-29-49-11-139-168-195-13-132-3-161-70-15-145-155-152-140-183-34-55-62-18-124-106-180-176-194-166-179-172-66-94-47-148-20-185-86-113-163-103-89-127-187-153-81-143-35-109-0-111-8-21-82-77-141-61-91-36-177-5-78-175-136-31-73-54-80-190-193-1-156-198-117-121-131-125-90-122-63-102-135-32-100-107-40-133-10-147-6-188-169-134-51"
174,51974,100,26589,78563,15,"114-127-89-163-187-141-91-61-36-5-78-175-80-190-193-198-117-54-31-164-73-177-21-82-77-153-106-128-83-18-62-124-143-29-11-138-182-169-188-161-70-132-13-195-145-15-3-168-139-134-6-147-51-90-122-107-40-63-102-135-1-131-121-158-25-104-8-144-33-160-111-0-35-109-34-55-170-152-140-183-28-9-86-166-185-179-60-20-148-47-94-66-99-95-130-194-176-180-113-103"
175,51661,100,25528,77189,15,"95-183-140-149-28-20-148-47-94-179-166-194-114-127-89-187-153-81-21-177-73-193-54-131-135-125-90-191-51-121-98-118-134-147-6-70-132-169-188-133-122-63-1-156-198-117-31-190-80-45-142-175-78-5-61-36-91-141-77-82-111-109-29-35-0-144-8-104-138-139-11-160-33-168-13-126-195-145-3-15-155-189-184-152-170-34-55-83-62-18-128-124-106-163-103-113-180-176-86-185"
176,48411,100,23346,71757,18,"86-106-124-62-18-55-140-183-95-185-179-66-94-154-47-148-60-20-28-149-152-155-15-3-70-13-145-195-132-169-188-6-134-168-49-160-29-109-35-0-33-25-177-5-78-175-45-190-80-136-73-31-54-193-117-198-1-38-27-16-63-100-40-107-133-147-71-191-90-122-135-131-121-51-182-138-11-139-144-111-104-8-82-21-61-36-141-77-153-187-165-163-103-127-89-113-180-176-194-166"
177,53324,100,28122,81446,12,"139-138-182-25-177-36-61-79-91-141-187-89-165-127-114-137-103-176-113-194-166-179-47-148-94-99-185-86-95-62-18-143-159-124-106-163-153-81-77-87-21-82-111-8-144-104-160-33-145-132-13-195-168-3-15-70-188-134-118-121-131-51-90-40-107-63-117-193-5-78-175-142-45-190-80-73-31-54-1-38-27-135-122-147-6-169-155-184-34-55-183-140-152-170-189-109-35-0-29-11"
178,53379,100,25820,79199,17,"164-73-190-80-175-78-142-5-177-36-141-91-79-61-21-25-121-51-134-6-188-132-169-195-168-34-55-174-183-20-28-140-152-3-70-15-145-29-109-12-0-35-106-176-194-166-86-185-179-148-47-94-95-128-124-159-62-18-83-143-180-113-103-89-127-114-137-165-163-153-77-81-111-82-8-104-160-33-138-11-139-147-71-90-191-178-10-133-44-122-135-63-38-1-198-156-117-193-31-54"
179,50613,100,24218,74831,11,"41-81-153-163-89-165-127-137-114-103-26-113-176-194-166-86-95-130-185-179-66-94-47-148-20-28-140-183-34-170-189-145-195-168-13-132-169-134-125-90-122-107-40-63-135-38-1-117-193-31-54-5-78-175-142-45-177-61-36-141-97-77-21-82-111-56-8-104-33-160-29-11-139-138-25-121-51-191-10-133-147-6-65-188-70-3-15-155-152-55-18-62-124-106-159-143-109-0-35-144"
180,50953,100,22270,73223,18,"33-138-104-8-56-144-160-29-39-111-82-141-77-153-187-165-89-163-114-127-103-113-180-176-194-166-86-185-94-47-148-20-28-149-140-9-99-130-95-183-152-170-34-55-18-83-62-124-106-109-0-35-155-70-15-3-145-169-188-132-13-195-168-43-134-85-147-6-118-98-51-191-90-10-133-122-63-102-32-135-131-112-121-198-117-193-31-54-73-80-190-175-78-5-177-25-182-139-11-49"
181,50594,100,22903,73497,16,"133-122-63-135-1-156-198-117-193-31-164-73-54-19-112-121-147-6-188-169-132-126-195-13-3-70-161-15-145-155-55-18-34-152-183-140-28-20-148-94-47-179-86-185-95-128-124-106-143-62-166-194-176-113-103-89-127-163-153-77-141-82-21-91-61-36-78-175-142-190-80-162-45-5-177-8-104-56-144-160-111-41-35-109-29-0-49-33-168-139-11-138-182-74-118-51-125-90-191-10"
182,49662,100,24260,73922,15,"87-82-8-104-177-5-78-175-45-80-190-136-73-54-31-193-117-198-1-25-182-139-33-138-11-160-111-159-143-35-0-109-29-168-134-147-191-90-133-122-63-135-131-121-51-13-15-145-195-6-188-169-132-70-3-155-184-152-170-34-130-95-185-179-172-22-99-66-94-47-148-20-60-28-149-4-140-183-62-55-18-124-106-86-166-194-176-180-113-103-89-127-163-153-77-141-91-61-36-21"
183,49764,100,24298,74062,14,"1-135-102-63-40-107-122-90-131-121-51-147-6-188-169-132-195-168-126-13-70-161-15-145-3-155-184-170-152-53-189-109-35-34-55-18-62-183-140-28-20-148-60-47-94-179-185-95-130-86-166-194-113-137-114-127-89-103-176-106-124-159-143-0-12-29-160-104-8-82-77-81-153-187-163-111-144-33-138-182-25-177-21-141-91-61-36-5-142-78-175-80-190-73-31-54-193-198-117-156"
184,51729,100,25100,76829,18,"89-127-137-114-194-166-176-113-103-163-153-143-106-124-86-185-179-66-94-47-148-20-28-183-140-152-170-55-18-62-34-35-0-109-3-70-15-145-195-188-169-132-13-6-147-10-178-133-90-191-125-51-98-118-121-131-122-107-40-63-102-32-135-1-117-193-31-54-198-164-73-136-175-78-80-190-45-142-5-36-177-25-139-168-11-160-33-29-39-111-144-138-104-8-82-141-97-77-81-187"
185,51685,100,23157,74842,18,"118-98-51-125-191-90-122-135-63-102-38-27-1-156-198-117-193-31-54-73-177-21-87-82-8-104-56-138-182-74-134-6-147-192-188-169-132-195-13-70-3-145-168-139-11-33-144-111-160-29-12-0-109-35-106-124-62-128-22-99-179-185-130-95-140-183-20-47-148-60-28-152-55-34-18-86-194-166-176-113-103-127-163-89-153-77-141-61-36-5-142-45-78-175-80-190-136-112-121-116"
186,49816,100,23683,73499,17,"193-31-54-73-190-80-175-78-142-5-25-138-139-11-49-33-56-104-8-21-177-36-61-141-77-82-111-144-160-29-12-109-0-35-34-62-124-106-143-159-81-153-163-89-165-127-103-113-176-194-166-172-179-185-86-128-183-99-130-95-47-94-154-66-148-60-20-140-18-55-152-155-3-70-145-15-13-132-169-188-168-195-134-6-147-71-191-90-125-51-121-131-63-40-107-122-135-1-198-117"
187,52154,100,25180,77334,23,"124-106-153-187-163-89-127-103-113-180-176-194-179-22-99-148-20-60-47-94-66-166-86-185-130-95-128-62-18-55-34-183-9-199-28-149-4-140-152-184-155-189-29-35-0-109-111-8-21-82-56-33-160-49-132-70-15-3-145-13-195-168-169-188-139-11-138-104-144-177-5-193-164-73-25-74-118-98-51-90-133-122-63-135-131-121-117-54-31-80-190-175-36-61-141-77-97-81-159-143"
188,49234,100,23415,72649,13,"27-38-1-121-51-191-90-131-135-32-96-102-63-40-107-122-133-10-178-147-6-188-70-3-15-145-126-13-169-132-195-168-11-139-182-138-33-104-8-111-81-153-187-163-89-127-103-113-194-166-185-130-95-179-66-94-47-148-60-20-28-199-152-149-4-140-183-34-62-18-55-86-176-106-124-159-143-35-109-29-0-160-144-82-77-141-61-36-177-45-5-175-78-190-80-54-31-193-117-198"
189,51827,100,23467,75294,12,"133-10-178-90-191-51-98-120-71-147-6-188-65-169-132-13-15-3-70-145-195-168-11-138-33-160-29-0-109-189-155-152-34-55-18-140-183-149-28-20-60-148-47-94-99-185-86-179-166-113-176-194-114-127-89-103-163-153-143-159-106-124-62-35-41-111-81-77-21-104-144-8-82-25-121-73-54-31-5-177-36-61-142-45-175-78-162-80-190-193-117-198-156-24-1-63-102-135-122-44"
190,54060,100,26448,80508,10,"0-35-109-189-155-3-70-169-132-13-195-15-145-29-33-138-11-168-139-182-25-177-136-193-54-31-112-121-118-98-51-125-191-10-133-122-90-131-1-38-27-156-16-135-63-102-198-117-73-80-190-78-175-162-45-142-5-36-91-61-141-187-103-176-166-194-113-163-153-143-106-128-124-86-95-185-179-22-99-47-66-94-148-20-28-149-4-140-183-55-18-34-62-81-77-82-21-8-104-160"
191,52505,100,27272,79777,15,"13-132-169-188-6-134-147-10-133-107-40-63-135-90-191-51-121-193-117-31-54-73-136-190-80-175-78-5-36-91-21-177-25-138-33-29-160-11-139-182-104-61-141-82-8-144-77-153-163-127-137-180-176-113-103-114-89-165-187-81-35-109-12-0-111-159-143-124-106-128-179-166-194-86-99-47-94-148-60-20-140-183-9-185-22-95-130-62-55-34-18-152-155-189-3-70-15-145-195-168"
192,52327,100,25382,77709,17,"15-70-3-155-184-152-170-34-55-18-62-183-140-28-20-148-47-94-66-179-185-86-166-113-127-89-163-103-176-194-128-124-106-159-143-109-35-0-29-111-77-141-36-91-82-8-56-33-139-11-138-182-25-158-118-74-98-51-134-168-195-169-188-6-147-133-122-107-40-63-27-16-1-38-135-131-90-121-31-54-73-164-173-177-5-45-117-193-136-80-190-78-175-61-21-87-104-144-160-145"
193,51088,100,25827,76915,11,"13-132-169-6-188-70-3-155-184-152-34-55-18-62-106-86-185-179-66-94-60-47-148-20-149-4-28-140-183-95-130-99-166-194-176-180-103-113-114-163-89-127-165-187-97-77-153-81-143-124-35-109-0-29-144-111-160-33-138-182-104-8-21-82-141-61-36-177-5-175-78-54-31-117-80-190-136-193-1-38-100-40-107-72-135-63-90-122-131-112-19-121-51-139-11-43-134-168-195-145"
194,48546,100,22252,70798,20,"149-28-20-148-47-94-66-179-185-99-130-86-166-194-176-180-113-103-127-89-163-153-81-35-109-29-0-160-111-77-141-36-61-21-177-5-142-78-175-45-190-80-73-164-54-31-193-117-1-38-63-100-72-107-40-133-10-191-125-51-90-122-32-135-121-25-139-11-33-104-8-144-138-182-168-13-195-132-6-188-169-70-15-3-145-189-155-184-152-170-34-55-18-62-124-106-128-95-183-140"
195,51205,100,24391,75596,12,"159-143-35-109-0-29-111-144-56-104-25-74-134-139-182-138-33-160-11-168-132-195-13-145-3-70-155-189-15-169-188-147-90-10-100-40-107-72-133-135-63-122-131-121-198-117-193-54-31-190-80-175-5-177-78-142-45-36-61-21-82-8-77-81-153-176-180-128-62-83-18-34-55-183-140-149-28-20-60-148-47-154-66-94-172-179-99-185-95-86-166-194-113-114-103-89-127-163-124-106"
196,50656,100,23899,74555,26,"24-156-198-117-31-164-193-190-80-175-78-142-5-45-136-73-54-151-19-112-121-25-182-138-160-104-8-82-21-61-36-177-91-141-77-81-153-163-127-89-113-103-176-194-166-179-66-94-47-60-148-28-20-183-140-99-95-130-185-86-106-62-34-152-184-155-189-35-124-128-55-18-143-109-0-12-29-33-49-11-139-168-195-145-3-15-70-169-132-188-6-147-51-90-133-10-122-63-135-1"
197,50520,100,23495,74015,16,"89-127-137-114-103-26-113-180-176-194-166-172-179-185-86-106-124-62-18-55-34-183-148-20-28-140-152-155-145-15-3-70-13-132-169-188-126-195-168-139-11-49-33-104-138-182-74-120-51-147-192-6-134-118-98-121-131-90-133-40-107-122-135-63-38-1-117-31-54-193-73-136-80-190-175-142-78-5-177-61-36-21-87-8-82-91-141-77-111-160-29-0-109-35-143-159-81-153-187-163"
198,49693,100,24202,73895,14,"160-33-11-139-138-104-8-82-21-77-141-61-36-177-25-158-121-54-73-5-78-175-142-45-80-190-136-193-31-117-198-156-1-63-135-122-133-10-90-147-6-132-169-188-70-13-168-195-3-15-145-0-29-35-109-155-184-152-170-34-55-124-106-18-62-183-28-20-140-199-60-148-47-94-66-179-185-99-130-95-86-166-180-176-88-113-194-137-114-127-165-89-103-26-163-153-187-81-111-144"
199,55084,100,27599,82683,15,"86-166-194-176-180-113-103-89-163-187-146-153-77-21-82-8-111-144-104-33-138-11-189-155-3-161-70-145-126-168-195-169-188-6-132-13-15-184-152-170-34-140-28-20-183-55-18-109-35-121-112-73-31-117-193-80-190-54-198-156-1-131-51-90-191-135-32-122-96-63-40-107-133-10-147-134-139-0-29-160-25-123-5-45-142-175-78-177-36-61-141-81-143-106-124-62-95-185-179-99"
200,52618,100,25744,78362,20,"137-75-114-103-26-113-194-166-176-180-106-143-124-128-95-185-47-60-20-148-94-179-86-62-18-55-183-140-152-34-29-0-109-35-160-33-138-177-136-73-54-31-193-190-80-117-1-16-27-38-63-135-32-122-131-121-90-51-98-118-134-139-43-145-15-3-161-70-132-188-147-6-169-13-195-168-11-144-8-104-87-21-82-111-77-141-79-61-5-78-175-142-36-91-81-153-163-165-127-89"
