SolutionID,TotalCost,NumNodes,TotalDistance,ObjectiveFunction,Cycle
1,219856,100,170269,390125,"111-140-171-170-198-147-149-199-193-197-162-66-11-107-78-2-146-42-167-72-44-61-183-188-133-75-74-86-8-132-53-104-129-195-58-69-43-96-191-40-47-33-39-88-85-141-57-139-6-90-175-117-182-59-112-60-105-35-163-22-19-131-63-180-18-109-135-130-152-34-87-93-1-179-64-174-102-116-100-65-137-82-158-192-134-23-177-185-124-92-56-115-196-118-151-10-77-165-108-12"
2,224426,100,171077,395503,"112-72-10-157-119-97-99-185-178-166-83-197-57-179-168-61-191-114-44-81-139-41-174-40-127-73-152-20-95-50-11-52-36-164-75-87-190-90-4-28-160-62-148-176-154-159-0-38-184-1-45-24-79-19-94-84-76-9-67-92-22-46-115-167-101-51-12-77-108-2-105-55-26-100-177-122-110-123-121-39-183-129-144-91-138-143-134-68-32-53-128-189-145-49-193-186-120-93-192-165"
3,201436,100,150945,352381,"42-149-108-132-166-11-148-83-110-182-141-138-40-107-24-79-5-93-25-160-99-145-89-98-171-30-81-73-78-158-2-44-112-17-95-67-71-10-102-3-199-109-32-190-172-191-1-188-127-86-180-129-163-60-104-125-169-69-96-22-113-170-16-12-150-128-119-181-154-62-103-174-192-165-164-122-161-187-66-186-153-152-101-134-176-82-94-155-135-38-56-58-68-33-72-167-146-57-21-133"
4,219251,100,171929,391180,"77-115-121-179-158-41-71-163-154-80-145-86-45-83-139-73-62-156-176-0-162-138-14-51-194-12-3-125-69-55-180-37-141-56-189-94-66-104-2-93-13-24-72-81-165-188-90-182-161-28-91-79-70-126-172-88-11-17-98-26-186-177-34-1-185-96-75-42-78-21-197-178-160-60-30-38-103-111-173-122-171-187-148-99-76-131-166-9-129-195-175-4-128-190-95-105-61-113-46-64"
5,213423,100,163059,376482,"194-166-26-178-147-22-111-148-0-158-58-192-157-132-98-62-89-116-114-138-135-196-60-74-140-41-75-17-28-181-52-91-120-83-171-71-10-20-6-15-186-11-188-79-37-152-128-49-43-76-90-104-27-54-94-129-142-97-167-139-3-122-175-143-14-121-199-65-53-73-190-133-66-46-185-156-12-110-162-5-77-42-107-34-1-19-125-80-195-56-31-159-50-85-168-146-9-173-68-25"
6,225087,100,174923,400010,"181-28-198-8-86-118-39-176-17-113-116-136-41-194-115-4-146-105-63-199-19-182-137-168-192-73-143-74-191-104-126-46-141-173-156-190-52-95-152-49-153-147-76-57-0-58-98-162-45-26-37-21-189-9-138-11-148-32-120-144-89-165-72-195-183-112-12-34-79-78-96-22-111-55-102-185-80-135-75-142-184-196-151-88-23-133-121-67-124-54-44-154-81-31-82-47-107-157-123-108"
7,208753,100,158766,367519,"82-195-41-160-23-120-66-53-144-145-90-124-125-131-4-54-193-89-88-35-80-30-188-192-196-97-137-9-47-163-186-197-29-0-156-94-175-168-119-141-48-122-11-102-158-128-100-151-87-174-113-71-134-187-173-148-1-154-21-25-67-39-85-161-51-26-68-75-77-171-157-176-133-138-149-127-105-33-167-56-184-181-15-166-110-142-164-73-64-61-12-117-107-108-159-98-18-57-182-109"
8,214975,100,163562,378537,"163-72-171-153-185-167-140-152-114-88-162-148-180-22-95-136-122-36-63-145-67-41-121-108-50-30-168-62-191-32-89-105-17-182-86-69-127-178-173-192-170-124-82-144-166-138-194-157-128-172-25-2-11-39-71-164-8-90-9-120-60-81-76-151-42-112-169-115-46-130-109-92-23-133-150-84-134-37-85-79-158-132-75-111-103-196-20-187-94-27-119-143-53-113-74-181-101-104-118-161"
9,219343,100,168833,388176,"23-194-139-102-15-90-199-136-50-117-57-41-82-63-171-43-165-162-140-184-152-33-114-198-13-122-119-78-135-146-66-44-54-26-172-125-55-89-178-83-176-150-143-181-92-70-100-190-21-188-36-11-2-111-59-124-167-142-175-128-9-56-154-65-118-157-131-147-196-99-87-32-46-161-187-149-6-81-130-75-10-105-197-134-123-132-133-16-88-22-29-98-183-86-103-53-112-38-169-68"
10,197255,100,148030,345285,"81-170-146-111-187-112-182-35-160-57-88-118-107-65-162-78-171-109-87-58-136-156-80-13-3-61-8-93-184-197-133-175-44-19-181-71-11-25-121-191-100-149-188-30-131-27-2-91-124-138-94-39-144-176-168-115-164-194-147-76-110-155-99-60-54-84-12-23-177-137-7-145-128-5-59-82-53-64-154-174-38-85-135-105-37-134-163-132-103-119-6-83-195-1-117-28-125-73-189-62"
11,204586,100,157903,362489,"197-121-139-97-98-92-66-111-166-58-143-19-183-118-164-189-7-172-109-170-69-23-188-114-168-88-193-146-25-110-40-68-91-8-29-153-199-90-190-133-169-130-22-77-30-72-123-32-161-15-176-174-167-116-113-194-13-99-28-106-187-64-196-95-157-178-198-0-61-3-20-152-171-78-89-149-35-37-186-137-33-56-107-53-145-154-127-125-52-100-135-173-42-94-159-126-47-103-70-144"
12,224424,100,173425,397849,"92-40-47-98-55-101-96-79-166-30-22-1-107-156-49-188-63-57-116-82-157-117-66-65-35-12-51-70-54-160-118-44-20-164-120-60-52-148-136-141-72-0-105-179-167-68-165-18-75-183-175-86-6-89-8-108-104-137-110-59-159-28-3-151-186-138-128-173-180-124-64-58-24-29-115-16-37-88-41-73-4-31-87-7-90-169-132-106-15-196-170-123-53-39-178-95-182-14-81-71"
13,206651,100,158997,365648,"52-148-14-109-23-5-60-58-131-51-152-105-144-92-142-110-57-138-185-15-34-177-122-30-78-45-179-76-89-161-80-71-99-166-106-133-29-38-149-39-17-104-18-197-156-20-10-25-163-184-190-192-44-107-24-191-170-103-97-126-77-36-19-136-73-82-88-121-50-157-113-55-85-162-130-31-165-172-53-119-167-46-116-3-21-125-32-47-159-145-102-98-4-124-65-6-140-183-198-118"
14,204771,100,154136,358907,"117-47-72-16-198-93-185-88-62-49-40-127-77-14-144-98-23-131-10-190-167-141-156-111-82-6-80-153-2-95-103-149-148-56-37-107-91-50-57-87-116-63-126-189-170-35-166-8-24-197-27-125-17-104-176-54-76-150-94-180-9-71-109-123-155-119-192-159-38-90-154-114-12-164-187-66-143-61-162-65-157-85-33-42-196-138-30-134-147-120-118-171-73-113-7-115-36-165-59-75"
15,209410,100,161725,371135,"84-13-76-104-133-74-123-3-63-12-191-49-176-197-30-15-59-83-165-11-184-126-175-134-155-73-31-137-37-152-189-118-116-85-145-35-72-147-117-10-55-5-1-103-114-69-70-77-100-33-163-39-124-111-18-171-47-144-108-139-8-38-0-120-94-56-48-102-67-54-148-68-95-109-43-97-89-127-92-142-130-44-183-199-188-45-23-52-190-129-87-178-186-115-164-187-154-78-156-21"
16,211929,100,163835,375764,"60-55-30-75-13-74-145-100-23-107-77-114-132-79-36-87-121-131-146-142-139-187-153-143-40-183-54-24-52-86-66-64-12-3-164-53-91-50-188-161-48-106-81-78-110-21-169-123-46-6-134-156-97-159-96-20-42-29-186-83-129-163-26-44-199-101-28-80-166-124-115-144-105-190-56-99-15-67-47-170-126-152-117-149-35-137-98-41-181-27-33-189-19-59-150-5-173-194-89-111"
17,188700,100,143407,332107,"109-56-3-153-197-17-151-33-155-131-36-128-104-12-168-136-193-118-191-116-138-190-111-120-89-98-163-114-177-179-22-21-31-148-8-55-65-162-41-97-57-20-14-15-192-0-199-91-86-126-101-127-159-82-7-113-24-152-181-156-9-117-122-1-53-183-124-99-171-119-80-38-169-11-182-25-78-5-39-160-59-175-6-167-61-44-132-161-147-74-157-178-95-71-158-184-13-146-188-40"
18,219317,100,168892,388209,"35-47-77-156-39-69-120-115-177-125-145-175-101-110-152-111-71-92-119-147-17-161-50-74-159-85-107-168-143-172-188-185-104-171-113-178-108-132-73-155-162-170-146-66-160-36-148-81-40-64-98-154-127-22-42-37-112-128-14-56-89-34-8-87-90-157-122-116-189-164-197-80-31-55-117-26-100-198-75-29-123-93-186-134-11-5-1-52-141-10-65-57-20-167-96-25-149-68-28-194"
19,203141,100,156159,359300,"23-34-13-196-41-62-138-5-112-30-175-78-116-1-89-164-57-96-45-192-185-186-143-168-84-102-101-82-17-44-128-77-167-139-149-72-8-141-193-106-32-70-121-109-47-170-152-49-60-94-74-159-85-161-19-190-68-108-66-75-103-67-110-43-36-95-179-71-90-105-177-150-155-61-184-16-80-162-99-63-147-10-189-188-54-158-194-144-59-26-79-18-183-20-92-198-160-52-137-127"
20,236833,100,184390,421223,"26-188-44-160-151-61-128-118-186-148-142-4-196-83-98-114-173-49-166-20-55-10-28-11-102-170-17-176-190-57-131-0-96-74-7-71-124-75-33-110-67-157-41-56-108-18-39-137-19-106-58-172-46-66-97-161-130-16-90-184-165-174-136-126-117-30-152-156-53-145-104-101-36-139-182-123-169-105-23-72-70-77-50-91-62-116-89-134-119-168-59-43-129-82-149-35-25-191-167-189"
21,222206,100,175600,397806,"98-112-157-90-52-153-192-182-64-145-146-177-61-91-8-137-136-185-171-53-134-10-88-133-17-30-104-130-141-148-161-92-40-106-63-9-44-80-99-2-96-111-152-108-71-195-32-7-103-87-180-109-79-31-47-121-69-43-165-46-139-120-62-124-18-193-175-155-116-188-187-6-118-82-123-101-34-168-25-22-122-178-94-169-142-186-5-128-12-81-4-54-179-197-105-117-86-198-23-163"
22,214696,100,161373,376069,"134-54-94-160-42-145-154-81-30-123-124-97-181-157-7-29-107-194-195-159-21-53-193-79-180-96-146-50-85-80-45-22-91-137-71-19-90-17-121-41-168-156-109-103-58-148-125-1-132-8-76-83-173-189-151-49-163-172-4-40-130-138-116-44-12-174-110-31-164-57-11-142-77-73-68-65-119-129-118-9-128-56-61-102-171-199-127-59-24-187-113-158-3-6-74-104-178-0-136-39"
23,208659,100,159227,367886,"55-29-70-140-86-182-83-4-59-78-173-145-150-184-163-0-127-37-14-169-129-164-118-188-143-114-179-90-162-87-50-159-192-74-61-121-52-117-183-30-60-133-131-24-11-178-123-103-172-94-181-146-91-32-85-20-10-63-35-16-166-189-107-76-171-65-72-22-57-137-95-108-156-112-23-54-48-177-175-97-142-190-53-116-110-13-81-176-9-198-128-119-93-161-138-21-12-185-75-167"
24,211556,100,160752,372308,"37-3-0-146-21-110-186-74-82-173-54-30-58-66-176-99-67-180-155-47-116-120-142-160-141-119-46-78-88-129-111-9-115-107-12-113-29-69-70-151-53-39-95-153-178-91-16-190-196-28-100-83-109-32-34-2-197-40-188-17-175-182-15-137-126-136-181-122-62-162-77-108-189-161-6-199-51-121-94-145-194-44-81-179-90-96-183-60-10-138-52-87-64-118-125-158-157-61-26-105"
25,214979,100,162483,377462,"158-52-20-189-115-23-46-180-173-92-58-47-64-21-129-65-32-44-98-27-25-133-125-30-9-84-119-54-22-128-17-2-63-184-191-152-172-169-111-59-43-154-170-194-14-161-156-155-177-49-103-137-112-196-190-113-131-153-144-118-53-168-81-121-5-140-36-104-143-114-88-110-188-85-77-174-186-10-13-75-97-102-142-41-175-69-73-185-134-167-0-135-195-193-147-164-199-151-39-12"
26,214140,100,163045,377185,"102-116-131-178-25-170-16-58-23-146-15-103-14-150-66-108-175-12-87-93-135-119-62-106-105-41-27-86-177-179-9-147-37-92-3-183-43-72-65-68-32-78-2-51-18-195-101-74-50-165-117-104-198-157-123-109-155-168-44-29-167-127-45-129-94-128-188-181-149-47-83-162-107-110-124-95-42-97-61-48-152-100-20-64-30-126-11-133-53-140-77-35-33-22-154-173-40-91-171-70"
27,206107,100,155663,361770,"192-4-48-0-172-44-147-150-10-7-91-116-98-57-186-152-154-140-49-107-114-14-13-133-136-193-112-120-67-20-71-126-83-1-73-95-101-127-119-47-113-43-141-86-106-131-174-105-50-40-62-82-19-195-23-78-156-142-64-69-182-177-6-149-17-128-74-144-183-162-102-118-179-18-75-68-34-28-111-88-121-199-155-100-151-160-5-24-143-122-158-194-132-145-76-124-189-84-59-157"
28,208062,100,162134,370196,"99-179-172-189-62-31-104-168-37-178-155-63-65-55-42-34-89-188-81-58-195-184-191-115-47-72-145-143-176-102-182-87-177-21-103-139-117-132-199-29-186-192-64-175-161-16-14-85-25-82-110-107-147-128-0-79-134-77-52-125-150-59-98-194-20-121-160-22-18-131-157-100-124-8-92-35-70-1-148-50-112-96-108-137-27-126-129-26-13-169-17-39-159-38-190-193-181-138-153-130"
29,211445,100,163468,374913,"172-160-146-99-52-5-113-123-195-112-126-30-65-25-168-171-13-12-139-121-142-102-72-185-20-158-86-38-53-35-107-15-81-119-186-82-104-64-17-90-197-149-61-22-163-71-3-88-19-91-114-51-100-165-97-143-63-56-192-58-18-7-28-47-184-174-93-122-138-183-83-194-78-154-50-31-148-155-98-181-153-96-135-132-177-36-44-187-40-193-80-26-62-43-110-173-147-130-66-189"
30,223724,100,172415,396139,"78-105-69-28-79-71-91-171-141-139-124-112-29-35-102-170-147-130-145-135-199-15-195-13-46-27-176-17-6-43-196-103-4-10-55-0-117-125-1-50-165-5-100-39-173-146-49-37-22-31-83-114-110-133-128-54-23-11-193-108-111-123-183-85-48-24-136-180-188-194-182-115-93-174-89-166-142-52-3-57-70-162-62-172-129-161-101-18-61-65-148-158-74-132-14-75-189-81-19-58"
31,221908,100,170514,392422,"197-199-172-150-110-56-31-130-42-74-196-33-2-35-53-76-134-83-111-59-107-140-182-98-163-96-118-105-113-45-153-183-171-121-64-48-67-117-114-144-46-30-181-122-77-194-4-109-127-62-143-101-75-97-129-164-23-142-137-29-28-7-15-5-115-119-14-18-16-87-168-10-72-132-191-151-52-190-106-26-124-58-195-79-161-146-160-89-173-145-90-133-108-128-21-0-180-131-24-120"
32,207787,100,159572,367359,"47-91-79-13-20-117-170-74-154-146-166-25-66-69-142-191-26-181-83-116-152-162-168-126-32-104-7-175-68-89-5-28-135-6-61-52-94-196-84-132-19-53-174-121-129-110-29-177-103-131-171-14-67-148-12-186-64-81-63-140-86-138-43-37-188-133-34-139-169-160-127-0-176-180-99-115-136-36-145-118-46-38-95-23-192-122-49-130-134-109-182-107-1-185-72-105-147-158-2-114"
33,199186,100,151760,350946,"76-113-75-69-93-137-59-184-103-33-174-194-25-121-7-170-146-147-13-55-127-77-12-68-54-5-58-80-108-156-181-34-167-136-173-51-96-79-101-87-126-117-41-125-62-165-195-135-32-128-8-35-155-95-100-199-94-90-168-16-130-161-193-115-153-162-198-9-139-50-116-40-60-37-44-129-111-132-15-145-192-160-138-52-85-158-11-141-3-20-106-110-28-191-38-166-177-57-46-169"
34,220837,100,172466,393303,"24-128-38-83-59-27-118-147-45-62-101-117-1-192-28-105-199-55-67-151-66-170-160-29-44-22-52-88-195-19-120-188-11-196-57-114-135-5-154-121-102-126-163-113-91-132-53-87-98-47-94-42-109-4-145-131-153-108-123-60-89-36-12-103-165-112-179-50-148-25-74-30-197-185-198-79-136-177-193-71-26-78-43-146-180-20-51-166-116-0-111-133-90-173-110-34-119-190-49-93"
35,210123,100,159959,370082,"188-113-135-98-103-152-166-9-131-34-89-5-33-132-174-186-50-136-74-86-96-184-54-176-162-142-129-52-165-155-68-150-105-20-159-88-156-172-109-44-43-83-70-133-97-21-146-194-110-191-65-106-81-75-187-163-82-169-84-101-72-183-121-47-14-41-199-185-180-145-71-107-11-93-36-56-4-25-51-144-171-125-19-42-76-175-182-189-112-137-2-17-168-66-58-64-181-173-16-55"
36,218388,100,168467,386855,"65-7-135-133-187-40-27-197-102-157-175-44-19-59-67-113-125-192-47-115-61-88-60-71-132-13-36-48-97-70-99-193-77-122-184-120-100-165-112-104-76-152-37-46-196-4-33-38-64-145-160-170-121-54-150-195-74-25-155-177-55-128-9-130-28-2-106-3-1-146-134-29-53-116-86-26-90-182-194-110-156-154-144-173-109-153-161-101-6-75-117-87-23-39-50-58-15-95-78-180"
37,211521,100,160477,371998,"171-170-57-64-60-181-89-34-199-45-179-173-47-23-69-36-76-175-139-42-124-109-48-188-154-77-114-193-168-191-18-121-1-32-14-187-70-61-92-180-146-73-127-68-123-82-12-111-161-115-3-2-135-72-148-133-0-128-81-55-21-91-49-130-52-16-159-118-97-150-51-66-46-95-110-39-44-157-122-107-192-101-65-4-104-53-6-31-33-75-87-142-83-176-167-160-147-156-103-9"
38,208666,100,164028,372694,"23-15-161-133-62-130-94-86-90-96-53-66-1-46-78-41-63-29-194-135-155-71-36-31-147-162-143-187-131-84-10-149-22-141-183-3-73-121-167-65-180-125-105-140-192-166-195-39-116-69-174-199-178-132-119-80-74-158-154-190-191-57-182-11-170-110-172-42-123-91-112-118-108-164-169-165-146-45-117-27-137-92-77-61-99-33-107-113-127-145-122-28-68-176-106-197-6-35-70-188"
39,217278,100,163298,380576,"135-100-42-61-115-68-197-54-178-161-57-69-53-130-182-198-181-0-112-145-97-63-146-119-67-31-187-108-142-58-59-51-196-176-169-185-138-150-15-35-124-101-99-52-192-194-64-157-90-50-129-65-105-11-183-76-120-48-81-167-195-80-173-96-148-47-162-34-102-36-25-123-111-19-87-85-174-40-137-30-17-149-143-156-126-154-113-46-2-10-78-133-91-186-4-155-93-140-153-1"
40,224024,100,175311,399335,"76-104-155-183-37-191-80-184-74-4-73-161-100-119-14-89-27-72-146-176-169-107-57-13-42-127-144-67-17-141-51-86-49-143-128-34-165-101-98-56-47-0-65-153-185-167-102-62-11-38-171-109-43-33-30-52-8-94-157-135-123-139-131-6-125-116-59-197-5-196-150-87-190-193-186-15-140-138-148-133-178-9-181-31-111-162-194-25-20-166-1-180-41-48-114-99-32-23-115-136"
41,210997,100,162032,373029,"174-133-184-58-128-77-147-159-92-181-121-198-107-36-78-188-115-169-176-52-127-134-97-102-44-55-89-192-68-9-63-158-145-53-123-21-167-180-101-130-168-66-62-34-67-23-141-6-65-112-56-186-106-163-2-22-80-124-172-143-154-90-46-150-132-48-74-120-76-61-179-45-99-131-137-164-155-191-126-177-96-86-64-25-183-15-109-12-70-69-29-82-173-138-152-113-7-16-91-114"
42,224836,100,175026,399862,"167-158-151-196-162-48-191-169-1-194-122-25-52-150-152-100-111-109-26-7-170-141-78-171-31-90-108-184-0-126-66-120-186-133-60-35-82-182-153-46-97-143-91-101-54-98-27-21-112-103-17-85-146-128-188-40-127-189-119-125-129-83-116-187-136-22-164-104-81-139-30-34-154-6-45-102-3-179-142-155-134-198-161-124-145-130-107-192-43-2-163-8-20-140-56-59-93-4-24-77"
43,207405,100,155655,363060,"5-173-50-195-129-99-196-139-101-160-193-120-179-123-110-175-44-60-91-156-141-46-87-89-116-62-82-43-10-199-51-189-145-12-168-19-180-154-4-42-83-64-23-72-7-177-1-55-172-137-111-59-155-38-197-191-136-67-161-169-14-71-3-6-49-131-18-20-124-35-147-127-118-162-22-167-135-187-88-15-29-74-30-176-56-142-171-152-47-186-98-24-178-192-194-9-97-149-11-41"
44,203674,100,157057,360731,"20-190-29-141-151-89-26-106-100-112-88-69-28-111-62-181-91-81-132-74-47-52-87-127-147-167-186-179-138-38-85-72-37-126-32-184-164-54-83-109-195-173-140-130-76-35-12-191-65-153-8-142-152-21-165-95-105-175-93-166-55-42-163-177-113-146-116-5-194-178-77-158-44-70-133-10-56-82-128-150-148-169-182-193-104-119-107-78-63-96-99-185-196-187-33-149-180-68-17-14"
45,198745,100,152472,351217,"20-147-27-159-16-122-136-168-49-113-158-166-58-6-12-64-68-104-8-153-43-135-90-19-123-39-151-143-37-63-78-0-67-154-52-70-109-164-4-180-86-120-65-145-98-126-97-124-131-194-85-55-47-137-32-50-128-140-181-149-192-5-119-66-148-54-96-22-199-146-13-178-28-133-116-138-106-160-75-176-129-169-62-89-190-1-193-121-33-179-191-142-9-175-44-2-141-59-130-162"
46,203624,100,154050,357674,"18-32-158-22-194-126-57-70-178-180-50-15-172-108-186-174-151-33-49-96-90-162-44-134-11-8-136-61-101-188-111-190-53-16-17-187-38-72-85-87-12-110-91-20-143-176-58-198-165-52-179-60-137-191-117-37-84-97-122-119-128-124-113-100-69-56-131-104-142-82-175-109-193-34-118-43-102-62-146-116-195-160-132-66-199-73-171-74-36-26-51-185-88-154-130-95-121-40-78-79"
47,210661,100,164134,374795,"97-124-115-111-164-62-29-65-152-58-84-130-175-131-5-4-134-50-144-170-48-117-108-25-139-127-33-148-17-31-60-42-136-86-129-145-9-73-80-22-53-85-99-55-186-43-114-6-113-21-190-138-70-172-32-82-71-54-161-181-189-143-52-132-168-184-188-174-51-194-89-195-177-169-173-146-160-155-112-19-79-38-28-63-123-59-10-49-45-122-167-128-77-192-141-2-0-157-196-37"
48,211952,100,166421,378373,"172-117-18-35-194-92-125-47-192-160-165-138-114-17-96-140-6-40-115-83-15-179-129-151-3-2-102-86-108-75-28-61-111-166-185-119-123-175-148-157-145-131-42-90-186-31-161-158-77-0-136-13-133-98-81-105-8-9-191-51-198-21-167-154-88-30-109-36-20-152-62-110-39-19-176-134-128-156-164-153-174-146-103-82-189-169-44-10-155-33-199-163-65-4-137-73-57-130-124-32"
49,211850,100,163101,374951,"151-148-59-69-47-41-199-169-20-92-75-147-76-8-30-186-55-13-49-168-46-3-21-111-26-146-174-89-188-119-58-132-121-2-42-24-60-122-72-101-139-71-141-150-93-87-29-135-190-114-102-40-123-133-144-187-5-110-115-171-104-159-80-182-178-70-33-165-35-154-185-183-125-193-112-34-106-53-67-56-120-65-11-172-152-156-18-74-108-63-27-181-194-82-137-14-32-130-81-6"
50,214836,100,163610,378446,"116-19-13-167-173-42-83-185-123-107-142-75-91-60-97-189-105-164-52-197-58-161-199-113-146-133-9-195-10-137-64-6-132-169-103-23-56-39-17-109-148-128-89-99-93-45-86-182-28-8-73-90-30-46-171-72-186-165-147-114-82-49-130-154-76-106-92-166-57-63-124-121-157-122-131-125-176-20-81-36-178-159-5-11-145-68-59-50-79-66-25-12-48-153-37-118-149-43-35-27"
51,214112,100,163241,377353,"145-19-165-98-21-162-190-171-196-168-83-31-148-108-80-73-69-176-3-55-157-96-15-139-85-67-20-120-152-13-41-79-84-137-58-187-0-127-170-116-183-153-166-57-128-64-93-173-175-14-126-50-117-184-2-180-56-101-124-181-44-193-76-5-161-179-95-28-78-62-156-42-100-7-185-35-6-105-10-151-48-46-72-97-26-52-188-8-34-24-149-172-103-43-71-92-81-107-194-51"
52,217567,100,168596,386163,"16-195-64-21-19-91-111-131-174-92-76-26-8-110-88-116-32-57-33-196-121-28-54-14-68-71-161-112-100-128-4-25-84-173-108-56-153-145-170-156-103-114-27-102-122-67-140-90-125-120-43-81-137-30-97-147-148-44-0-160-29-135-193-138-163-51-113-13-20-166-117-194-182-6-46-38-12-41-98-152-184-66-149-132-104-199-1-69-60-82-151-162-52-169-178-146-142-188-165-93"
53,225503,100,176801,402304,"82-148-86-156-96-183-32-197-166-139-106-163-90-51-24-161-117-74-68-170-31-110-127-30-77-186-154-158-22-8-92-50-20-72-179-135-97-115-145-100-4-28-6-155-19-57-105-27-67-61-41-175-93-187-3-23-70-56-114-129-188-151-63-34-132-168-185-75-153-123-60-157-35-150-112-119-5-184-46-9-13-62-26-174-198-11-85-195-80-167-124-44-133-53-107-192-84-190-116-130"
54,227097,100,176671,403768,"52-3-98-99-15-81-168-110-6-101-121-148-48-100-170-105-180-20-179-45-43-151-40-82-156-137-163-193-116-119-152-27-115-142-47-56-84-184-140-187-114-86-104-93-128-125-155-33-135-117-37-176-83-35-31-164-4-198-107-53-112-186-76-192-173-183-169-199-139-94-118-9-143-133-79-161-85-197-11-136-50-127-24-106-12-182-146-68-130-162-67-14-23-16-102-1-159-144-154-131"
55,205291,100,157725,363016,"173-89-151-53-155-44-102-138-115-129-106-28-87-100-25-24-196-120-182-134-59-2-111-48-128-82-55-118-29-131-146-123-71-0-7-175-99-107-174-12-46-116-10-172-86-58-47-145-93-199-104-8-84-11-81-117-153-77-17-67-36-195-190-142-51-40-18-76-98-187-20-57-60-22-168-125-64-23-54-108-166-170-183-160-136-127-95-19-3-119-193-122-124-184-96-91-159-169-113-78"
56,209242,100,161097,370339,"59-116-38-65-51-112-11-176-74-25-45-102-152-83-138-36-157-188-169-7-186-165-19-150-182-113-136-167-78-70-195-61-147-142-82-106-34-40-62-90-161-72-14-160-48-1-117-187-28-183-24-154-20-58-29-133-181-107-121-109-125-197-135-184-77-128-177-87-178-31-132-3-66-139-174-68-57-16-199-180-17-50-42-53-8-67-79-164-97-120-5-27-69-56-168-118-146-156-190-37"
57,222311,100,171653,393964,"151-162-74-56-141-3-24-111-196-124-120-15-175-131-87-147-94-30-105-49-164-184-168-97-25-51-135-176-81-154-167-163-5-18-53-55-21-69-123-96-47-36-128-37-10-19-48-179-80-12-1-52-160-75-9-182-41-90-125-65-174-129-7-33-171-13-17-155-107-8-23-34-106-144-79-57-88-62-198-99-134-161-100-127-193-60-178-187-44-145-85-6-112-165-148-116-146-189-32-119"
58,224339,100,173566,397905,"93-88-86-49-186-158-10-153-58-12-41-98-57-193-142-25-155-21-90-1-61-182-23-74-135-34-181-15-50-22-26-63-39-174-69-140-5-7-47-184-19-167-94-117-159-44-118-100-196-180-187-154-169-113-108-70-107-139-119-148-133-48-42-171-121-116-20-122-132-96-198-14-8-166-197-84-106-2-43-161-194-54-162-183-80-164-59-52-151-3-163-16-45-101-56-173-0-24-27-124"
59,199366,100,149657,349023,"48-195-45-7-88-20-157-26-2-79-137-82-29-24-194-167-87-1-115-151-185-6-124-69-199-98-8-97-138-100-63-192-96-70-139-108-14-113-16-187-128-176-47-184-163-68-39-148-152-101-181-34-129-60-89-86-165-136-12-177-111-83-109-9-107-150-3-104-35-175-125-81-196-10-120-130-5-198-180-105-161-134-74-73-85-121-32-17-131-76-146-156-75-117-92-119-33-102-183-0"
60,193754,100,147156,340910,"165-176-63-47-109-113-72-137-52-142-89-111-186-3-94-134-169-83-23-184-96-188-49-4-126-155-122-182-86-8-36-191-82-162-87-84-139-163-174-112-70-102-189-34-190-29-39-19-175-124-179-114-93-153-100-43-152-195-132-45-46-177-92-51-1-38-65-135-129-185-14-138-5-183-9-161-42-58-32-98-118-159-50-30-12-97-99-61-136-173-171-0-25-24-78-33-59-88-48-107"
61,206050,100,157901,363951,"108-68-87-188-38-61-76-22-25-7-159-11-93-33-167-52-145-154-4-69-32-164-183-70-166-131-151-117-0-133-85-100-29-28-121-191-19-26-79-172-2-125-122-14-163-169-158-143-155-171-139-168-46-86-43-152-95-113-181-174-194-173-193-60-24-178-3-153-141-83-112-186-170-120-175-187-97-189-119-58-18-47-192-62-137-184-127-27-124-10-177-37-96-48-13-198-195-161-162-138"
62,209626,100,156405,366031,"144-16-99-183-198-19-82-114-2-169-160-89-90-67-127-153-10-46-133-74-86-6-5-58-154-52-101-147-148-122-24-185-158-168-23-38-105-117-45-190-123-129-57-197-175-115-48-85-130-128-28-71-44-125-136-43-146-39-60-120-195-66-165-50-12-68-108-156-37-192-8-56-27-78-69-13-41-59-124-191-119-83-166-20-70-54-142-172-7-134-9-14-88-87-31-92-180-33-121-65"
63,213215,100,161768,374983,"4-133-173-94-128-10-102-85-8-108-178-81-176-83-174-41-74-78-88-19-29-89-122-170-6-142-126-20-53-66-0-5-32-129-140-27-101-172-154-186-109-110-105-3-183-158-56-42-187-70-161-17-192-96-69-182-65-2-25-113-63-175-21-196-40-139-35-48-54-177-194-180-38-84-165-164-22-181-76-121-112-104-67-80-159-36-191-115-120-59-157-43-185-7-198-107-168-114-75-118"
64,222500,100,170033,392533,"190-14-173-20-194-37-132-133-148-159-75-101-44-27-160-62-5-199-88-66-9-54-149-47-42-43-115-162-89-161-61-55-58-72-138-16-142-18-34-196-136-116-95-33-0-82-167-69-26-144-39-176-56-31-180-99-65-197-155-152-125-1-3-123-74-91-59-84-45-98-17-76-24-90-63-80-64-172-107-183-110-11-127-186-151-187-193-114-192-46-67-198-105-40-51-23-178-113-93-2"
65,209066,100,156827,365893,"18-116-79-118-26-49-41-94-98-93-144-74-120-178-22-140-146-188-141-70-59-12-69-181-182-24-189-42-39-167-37-114-88-143-21-123-173-92-11-103-47-53-153-151-27-16-86-32-149-82-29-95-179-8-17-52-132-133-111-84-152-125-45-85-0-36-135-122-165-83-68-121-60-97-71-162-139-80-89-155-186-90-190-1-75-91-46-157-96-50-4-2-13-7-170-128-183-196-168-119"
66,202786,100,152452,355238,"188-20-154-101-85-141-138-74-108-41-40-42-71-55-92-21-195-179-191-148-182-198-72-79-142-105-147-24-103-114-127-129-0-33-175-144-16-84-162-134-18-152-126-32-97-28-36-48-50-137-76-61-163-155-153-83-192-145-135-25-116-166-109-157-190-186-119-66-82-99-3-46-158-160-149-13-110-69-26-136-51-180-89-143-161-132-102-131-14-60-2-65-86-123-181-133-7-178-91-81"
67,228892,100,179587,408479,"179-61-197-105-62-96-35-9-159-185-70-3-196-184-21-66-115-140-45-182-65-28-73-199-57-82-42-104-127-13-88-46-16-173-60-192-181-17-121-141-30-44-95-11-142-190-152-98-153-43-167-188-123-81-84-93-195-20-25-92-103-15-0-68-156-76-50-187-198-191-129-178-135-124-99-10-151-59-139-150-33-5-31-97-166-23-162-128-175-71-125-37-145-120-177-51-113-126-26-131"
68,208162,100,157148,365310,"88-181-109-151-105-12-125-91-171-63-165-13-115-167-21-196-198-80-182-54-10-179-17-120-148-152-42-157-138-111-108-159-150-16-106-186-58-84-86-70-22-62-168-180-34-73-184-178-139-175-145-15-189-72-97-48-23-43-107-147-56-25-60-64-134-94-118-114-36-8-24-78-191-190-113-146-4-37-144-11-174-100-110-170-87-93-79-195-75-177-130-20-68-74-46-27-194-143-49-29"
69,202148,100,151432,353580,"121-107-26-180-127-12-126-165-77-171-181-49-177-46-84-37-111-153-120-101-148-173-69-117-134-164-74-158-18-146-102-17-159-24-168-70-137-55-53-85-36-22-25-38-149-114-182-59-73-119-145-83-2-140-99-138-103-178-65-51-151-72-160-41-42-98-109-154-64-143-110-56-16-52-4-29-142-80-31-93-104-61-47-156-92-118-1-198-116-95-197-106-188-152-124-20-28-43-62-87"
70,228389,100,178199,406588,"146-158-111-107-75-83-50-92-41-162-84-87-96-71-53-173-104-67-6-0-60-125-181-115-98-185-63-29-184-123-48-4-65-127-147-126-160-45-119-129-72-142-86-36-164-23-97-54-32-11-5-8-148-25-7-180-102-167-159-151-182-144-66-130-190-172-166-93-175-69-183-114-12-169-112-140-152-141-138-16-56-101-88-100-132-188-137-121-59-196-110-55-34-89-20-179-38-70-193-113"
71,216089,100,165417,381506,"93-101-4-141-94-26-42-12-61-86-160-2-31-45-130-198-118-75-108-13-62-71-10-67-88-1-187-79-107-113-132-66-38-116-117-30-16-73-134-24-53-36-110-186-161-81-97-188-49-102-83-52-148-84-138-166-143-87-43-173-80-32-157-15-154-56-19-195-177-171-192-145-34-182-55-44-54-0-168-176-70-170-127-136-85-194-199-191-185-178-129-133-111-46-35-183-74-100-39-96"
72,204640,100,155612,360252,"138-170-10-57-54-32-50-13-175-161-174-193-63-185-48-191-7-187-92-44-84-154-126-74-87-135-107-51-85-158-157-124-129-112-23-104-117-152-177-102-53-16-169-34-179-47-29-39-123-106-146-97-96-103-194-144-21-95-37-61-128-151-46-164-6-56-116-76-93-62-108-136-1-197-81-79-82-86-71-113-110-190-30-43-42-40-148-121-192-156-142-80-73-90-166-189-115-18-141-163"
73,200324,100,151864,352188,"81-83-164-51-115-173-156-77-169-138-184-42-59-144-70-64-65-68-8-91-28-74-185-137-49-189-80-76-72-87-103-133-35-17-157-69-55-29-125-154-117-32-131-71-129-126-191-151-7-170-60-183-25-123-61-62-143-187-176-166-104-134-167-194-107-90-172-85-132-3-84-146-30-88-181-20-158-186-37-78-139-86-178-94-113-109-46-190-110-180-18-99-161-0-73-108-34-95-147-41"
74,230672,100,177462,408134,"47-197-88-67-23-8-89-102-55-49-110-19-181-198-134-38-103-109-70-121-171-199-82-178-137-173-18-16-60-81-46-179-50-183-92-186-45-0-10-68-172-56-184-180-101-189-140-98-191-159-161-146-24-80-69-144-58-108-7-166-35-136-1-79-66-174-111-76-90-25-64-170-93-182-129-53-127-78-77-169-157-124-177-44-125-73-83-17-85-62-194-158-149-195-27-151-51-131-22-154"
75,222134,100,177168,399302,"25-88-187-42-90-145-48-64-14-84-131-178-99-51-32-89-194-193-174-117-143-65-161-79-183-111-0-160-16-53-81-127-82-11-101-102-140-27-121-177-165-40-106-107-190-151-168-6-21-195-73-164-141-100-142-197-191-62-22-24-148-72-175-166-12-19-132-133-153-124-77-1-37-180-150-119-155-189-63-188-75-58-7-44-87-78-134-113-138-18-147-146-15-8-159-93-96-95-116-179"
76,206132,100,155470,361602,"91-32-191-41-61-136-67-162-83-165-35-133-167-1-100-66-92-87-28-16-117-75-123-68-179-94-138-33-174-195-37-56-46-192-193-131-124-130-113-181-76-183-140-156-89-80-154-145-70-153-108-149-86-184-18-53-21-24-171-125-51-178-196-4-26-78-126-12-49-103-172-7-182-10-144-84-115-27-101-159-158-168-152-20-166-11-47-188-199-157-64-134-198-119-141-55-194-104-186-36"
77,210430,100,159801,370231,"125-158-198-199-110-92-107-29-159-114-23-66-149-49-189-9-69-31-61-126-96-77-41-167-76-37-79-46-188-193-131-34-192-127-16-129-178-6-48-137-141-128-28-135-153-94-8-72-174-95-3-17-151-180-186-78-22-47-81-122-142-90-132-139-83-58-170-136-33-99-38-44-181-154-18-175-161-4-97-84-100-133-115-36-15-1-53-64-191-67-152-85-60-155-13-89-106-45-173-62"
78,216235,100,166547,382782,"35-133-186-114-76-88-8-189-155-131-157-19-15-5-153-43-173-59-92-106-95-23-84-73-143-150-69-7-139-47-20-120-79-152-118-70-116-199-166-25-58-60-93-196-32-96-99-26-3-90-110-127-44-31-160-97-71-168-36-21-171-183-198-1-132-179-175-87-33-125-37-66-74-137-134-53-63-41-64-94-98-100-42-22-145-24-10-165-192-4-13-109-80-176-144-149-172-14-135-17"
79,212735,100,163901,376636,"73-65-101-59-4-133-10-57-190-98-14-172-68-48-11-26-37-99-106-38-95-167-7-47-17-89-142-46-81-16-63-177-78-115-40-130-140-86-195-52-156-35-29-76-87-155-139-79-162-199-131-132-185-149-148-1-72-126-21-39-189-182-168-159-31-129-152-85-187-104-144-70-18-96-184-6-92-178-105-93-163-123-94-80-88-160-13-71-58-111-147-103-176-109-0-118-161-136-9-44"
80,232217,100,183134,415351,"40-174-141-131-58-66-161-188-80-194-164-143-171-184-137-117-52-149-102-91-100-112-86-46-118-62-122-69-163-95-96-2-59-159-150-48-132-115-162-63-175-179-45-10-138-121-195-1-20-101-57-123-126-55-113-105-87-186-32-44-139-191-103-185-165-38-146-134-11-130-15-92-180-84-88-25-60-75-31-9-181-81-29-70-79-178-124-93-64-125-107-26-190-83-18-47-109-155-27-71"
81,207586,100,156834,364420,"137-50-10-154-161-118-25-5-0-79-127-102-196-172-55-53-178-111-46-151-58-27-52-15-9-90-65-166-163-66-71-8-88-99-164-182-131-167-1-150-82-48-91-124-42-32-73-169-62-69-34-177-144-139-92-105-123-130-104-13-44-170-110-38-143-80-190-49-152-4-185-109-98-93-83-180-181-155-35-138-187-18-84-21-64-57-96-63-12-188-101-29-97-125-76-41-120-113-183-54"
82,213159,100,164380,377539,"48-27-163-117-70-98-116-170-168-36-123-93-154-43-108-30-28-162-75-41-145-53-21-137-19-139-11-1-73-183-105-88-124-165-81-166-68-14-66-80-26-57-118-197-60-79-62-188-111-74-61-55-59-110-114-113-92-109-129-115-37-42-102-100-193-122-35-31-16-151-156-99-150-58-3-169-178-155-186-152-83-135-191-147-142-38-40-132-95-7-9-149-72-6-86-101-15-91-10-190"
83,219164,100,170482,389646,"44-15-90-154-165-38-151-198-13-91-161-88-183-124-31-111-5-191-155-8-105-39-47-107-45-95-189-123-117-18-149-176-162-137-103-76-186-86-27-119-174-10-28-130-126-171-163-181-24-148-78-108-23-0-84-133-87-98-75-64-190-22-42-97-49-145-12-102-69-156-121-160-89-141-70-61-82-180-197-136-17-172-77-66-92-147-37-83-4-125-9-11-85-7-25-131-132-34-3-135"
84,222258,100,169032,391290,"71-9-162-129-126-33-145-19-99-112-81-35-193-118-187-115-11-147-173-175-103-101-146-192-137-30-130-150-171-59-96-68-78-24-70-154-55-54-122-64-158-109-22-85-34-58-39-104-21-131-5-47-156-86-178-17-136-82-36-79-8-151-128-182-180-76-183-14-16-116-194-25-48-108-42-72-197-125-132-123-196-88-94-69-111-63-40-149-12-190-13-155-75-185-26-167-10-181-164-107"
85,206128,100,157723,363851,"88-42-133-134-142-52-117-112-156-163-135-169-129-37-13-47-127-121-144-91-56-8-173-168-108-77-113-184-190-41-87-96-71-165-85-2-99-128-81-138-192-67-98-152-132-178-157-197-104-48-97-151-12-103-25-69-10-74-80-171-198-38-116-4-179-187-70-20-140-94-54-174-19-186-105-131-118-158-130-92-36-50-62-72-137-63-147-180-183-15-100-79-18-166-89-153-46-189-55-32"
86,203042,100,155525,358567,"65-84-103-75-41-51-48-180-194-8-60-107-127-141-43-90-59-142-183-37-40-13-69-121-148-17-175-101-143-191-24-10-42-196-190-30-58-153-176-88-6-170-7-118-181-20-189-125-78-29-63-98-35-44-79-91-49-14-158-162-139-54-198-155-77-39-27-112-104-188-16-21-145-116-11-25-160-177-187-56-36-70-179-173-94-195-96-28-12-50-131-171-2-184-122-61-53-97-1-86"
87,221722,100,174456,396178,"17-88-183-145-142-168-34-41-81-199-36-140-6-86-24-19-1-160-21-105-114-144-179-18-110-40-95-31-32-99-146-111-10-71-22-184-13-135-8-92-143-127-113-139-153-97-136-132-177-116-100-196-181-59-174-115-57-23-102-47-122-52-125-189-117-12-124-185-151-48-72-28-50-165-62-187-120-26-68-63-27-93-64-77-69-15-164-173-53-79-60-134-193-109-91-61-3-54-175-126"
88,218225,100,166327,384552,"106-183-135-119-64-31-153-150-105-128-161-78-94-49-127-69-189-98-171-168-73-46-34-115-82-110-66-92-50-136-21-186-33-175-184-199-159-10-103-17-32-177-36-196-70-142-126-108-24-91-173-165-129-8-160-1-87-120-95-194-188-132-158-83-42-187-156-51-170-39-26-80-104-144-151-185-12-13-179-118-19-180-99-146-167-138-6-191-29-113-169-112-65-85-52-44-176-197-149-134"
89,206307,100,158825,365132,"116-11-108-27-33-67-138-195-168-148-117-126-124-132-134-166-151-178-147-8-182-143-56-92-74-86-35-104-197-150-60-113-141-175-50-24-83-38-155-111-95-164-51-156-22-41-52-66-184-63-142-172-59-17-103-19-73-75-58-81-48-21-6-152-125-61-179-71-80-76-65-123-87-62-187-185-97-15-5-133-160-161-115-7-169-177-145-28-98-173-118-192-34-91-88-68-69-176-43-174"
90,214630,100,163667,378297,"152-64-44-166-31-115-191-59-107-94-186-179-79-96-131-51-42-54-33-28-92-63-80-180-159-195-13-123-151-138-36-1-19-108-140-110-102-172-184-118-47-103-157-139-178-25-38-135-90-119-196-160-100-53-12-22-57-174-84-30-41-169-183-188-55-24-3-112-23-181-199-86-87-40-78-11-192-48-8-50-58-130-125-176-120-61-122-17-190-133-6-88-146-89-68-73-9-162-72-177"
91,202069,100,151923,353992,"20-174-127-147-135-19-116-197-30-169-163-4-125-69-186-48-145-114-101-105-29-119-102-189-109-184-27-38-115-175-156-172-43-192-171-13-11-53-159-160-35-168-117-177-194-131-142-16-70-128-138-0-111-46-167-60-88-49-161-144-149-79-158-196-182-143-104-37-74-5-179-40-21-54-51-45-76-52-93-180-181-124-170-6-77-96-28-152-157-198-113-87-18-36-23-98-110-2-94-120"
92,214652,100,169119,383771,"128-89-70-76-58-60-194-191-80-95-16-13-36-122-91-30-27-180-149-172-137-47-195-5-2-155-120-77-61-168-88-68-64-165-42-7-35-93-139-179-127-157-98-11-185-109-177-9-39-187-130-174-121-99-10-97-18-159-20-133-134-181-48-188-19-96-113-119-132-115-112-22-46-160-85-175-103-86-0-72-147-138-100-108-193-152-124-1-24-107-57-25-196-28-51-190-158-23-142-15"
93,235780,100,191432,427212,"98-17-149-121-67-120-61-179-19-129-128-109-147-93-15-111-21-50-11-138-107-73-60-113-89-39-10-63-0-135-59-161-40-3-78-35-164-183-27-77-66-130-31-181-100-177-34-117-33-44-13-118-18-7-42-186-136-189-176-70-123-94-95-82-115-165-16-71-57-182-169-172-90-132-75-152-163-197-162-20-122-146-32-52-144-188-1-87-104-22-193-170-92-53-81-156-12-198-4-28"
94,210888,100,162874,373762,"110-46-170-137-111-117-93-27-125-81-52-100-132-41-69-185-37-30-152-1-48-70-155-71-112-68-134-175-24-58-165-10-5-194-113-126-124-109-198-136-101-67-107-190-82-150-161-178-103-88-38-180-86-183-174-32-168-43-182-0-176-54-130-94-147-77-29-33-64-50-199-60-6-65-8-21-26-53-11-158-114-102-196-138-187-133-157-119-3-108-193-55-153-87-135-143-56-189-96-154"
95,223413,100,175834,399247,"87-127-48-112-124-51-130-121-68-78-123-135-142-183-91-161-140-101-5-195-2-49-70-162-159-106-190-15-13-22-79-177-152-198-169-189-82-95-156-184-63-172-179-178-100-47-96-125-25-131-103-151-158-199-104-66-16-11-86-7-38-139-138-45-144-107-85-14-164-111-24-94-174-77-50-36-163-84-180-193-29-73-188-27-76-18-88-176-129-17-57-119-153-32-148-30-167-26-74-181"
96,192223,100,147067,339290,"59-104-38-53-40-16-165-71-24-122-9-5-72-136-128-100-101-168-81-121-26-110-131-182-193-198-13-190-30-187-179-75-163-192-43-78-102-117-132-33-58-49-35-87-178-158-73-46-107-135-176-169-70-149-86-105-112-44-0-147-83-141-88-173-50-79-25-39-155-144-113-29-138-177-91-159-161-189-124-146-191-115-123-137-48-145-8-172-31-21-3-153-7-152-15-148-109-68-36-188"
97,219779,100,167228,387007,"193-70-89-188-181-50-81-118-142-95-19-189-87-53-4-92-93-20-164-32-88-139-175-34-158-184-135-37-134-18-33-0-166-74-13-65-138-80-148-51-163-185-151-76-128-119-103-152-131-116-150-73-102-11-42-155-133-167-112-10-82-14-2-16-117-124-104-61-68-115-194-120-66-1-17-44-178-170-108-55-140-195-56-130-28-111-49-43-64-196-159-96-123-54-59-67-132-129-192-71"
98,217074,100,167142,384216,"60-165-170-190-146-199-137-13-2-96-100-151-107-6-187-148-86-144-58-16-74-188-111-20-64-77-158-101-21-154-180-5-114-69-119-99-15-73-76-25-40-98-7-75-132-116-131-104-128-142-65-135-181-156-120-41-59-115-81-18-30-78-49-138-51-17-44-178-55-10-91-26-198-163-117-194-122-54-24-67-189-191-62-4-0-108-79-45-176-61-152-89-42-150-35-27-179-43-50-171"
99,221120,100,169038,390158,"111-169-140-19-109-74-89-194-46-84-5-32-54-17-143-158-162-35-67-33-51-7-101-79-59-99-171-192-80-168-37-28-90-64-29-36-61-185-8-30-45-70-177-42-167-131-68-102-53-43-132-126-138-114-58-27-38-1-83-60-21-172-47-189-190-10-182-50-16-62-73-174-4-69-31-22-52-127-100-14-175-148-156-48-173-26-96-72-41-82-65-150-119-107-115-24-164-163-196-125"
100,199191,100,149497,348688,"119-96-56-111-184-63-69-128-27-98-95-40-10-191-188-190-112-61-79-165-168-124-22-171-55-48-123-118-3-108-19-158-197-178-104-100-60-47-159-88-154-33-167-59-185-8-20-7-186-115-50-126-5-179-145-65-137-155-73-67-122-146-35-140-84-36-14-52-182-101-143-66-28-149-99-51-26-80-153-176-177-151-131-141-170-109-89-116-164-134-46-39-199-15-132-125-103-74-142-157"
101,204112,100,154004,358116,"101-28-194-195-156-5-2-191-115-152-175-182-140-83-169-180-19-161-124-37-142-164-51-133-184-154-69-72-63-128-25-193-54-167-98-103-165-84-6-155-150-120-131-36-53-102-95-100-121-27-160-43-12-174-57-112-30-61-47-105-87-44-117-0-119-1-73-9-15-11-104-4-126-48-99-42-18-41-179-137-148-22-189-77-183-32-7-88-159-31-178-80-125-55-149-162-176-197-146-97"
102,220675,100,167615,388290,"120-181-21-99-104-112-11-26-169-65-149-101-196-3-116-4-119-62-150-157-123-10-179-35-117-69-100-12-17-153-125-164-145-191-36-20-182-156-79-107-13-176-192-143-24-27-189-88-193-102-135-80-39-158-93-115-151-96-60-29-122-40-45-111-175-144-171-2-141-23-197-199-85-48-110-113-52-70-178-74-174-167-73-15-160-83-183-32-128-142-5-159-43-67-131-47-77-186-198-133"
103,206815,100,159283,366098,"174-63-96-85-107-191-135-53-47-186-195-155-198-31-156-103-124-111-77-79-61-137-179-46-110-199-21-134-133-122-60-196-187-5-150-81-44-24-6-29-102-70-128-144-151-172-23-1-74-157-62-25-131-27-58-36-190-188-169-18-148-84-182-113-94-143-193-88-7-75-164-57-9-177-167-73-108-142-39-13-41-162-50-66-176-109-80-55-173-76-40-192-112-64-30-147-10-78-145-123"
104,208513,100,156437,364950,"59-70-138-108-126-93-35-73-81-166-74-174-177-119-185-66-2-53-13-110-42-139-157-161-106-49-145-137-83-111-25-171-88-114-191-24-187-162-46-99-160-182-113-128-75-78-79-98-183-45-158-156-65-195-129-38-109-168-36-48-189-112-50-136-131-12-180-116-164-140-178-17-71-58-44-8-135-10-60-62-190-22-101-173-100-5-77-134-175-170-61-97-159-132-150-52-54-120-23-199"
105,208174,100,160729,368903,"113-168-158-42-38-84-195-46-17-194-124-135-34-196-122-176-83-55-106-24-19-148-197-56-36-134-59-9-76-181-133-72-114-174-43-78-157-29-153-173-30-64-189-187-15-144-44-74-138-177-94-171-2-27-91-126-18-20-73-109-45-31-164-11-102-67-198-150-186-26-137-98-93-3-121-60-70-0-146-115-123-99-147-77-33-116-143-179-57-163-37-1-4-128-71-165-183-80-75-47"
106,205571,100,157080,362651,"1-98-73-172-118-14-21-69-32-67-20-191-26-56-158-192-135-64-124-153-163-111-36-44-103-87-17-49-127-62-160-57-122-137-59-2-72-51-197-38-4-177-54-106-11-76-144-141-116-117-31-12-168-189-162-82-178-175-48-39-147-96-102-25-176-184-91-148-123-194-60-81-90-42-170-15-104-71-134-198-110-165-109-146-105-151-142-99-149-169-114-180-125-128-129-140-89-120-61-10"
107,197574,100,151767,349341,"107-54-158-124-1-55-198-197-141-132-179-162-129-171-74-103-159-37-191-150-151-5-65-25-125-106-126-83-138-148-16-110-7-168-18-42-49-157-188-175-128-93-194-119-109-189-33-66-51-80-40-156-38-104-50-58-90-43-161-61-96-72-15-4-101-79-120-81-84-91-145-89-94-11-147-3-153-134-117-142-29-36-113-160-182-27-62-121-75-137-71-155-115-99-127-76-35-48-86-17"
108,203165,100,153987,357152,"43-194-191-101-173-3-94-165-123-74-38-50-185-89-47-85-104-70-130-125-119-142-13-176-35-177-163-126-66-154-22-112-20-141-14-96-197-196-41-97-140-135-190-184-39-152-87-8-77-57-117-138-91-12-113-4-161-128-199-193-51-62-84-55-2-0-18-1-19-187-33-157-175-45-60-48-9-118-24-44-17-105-78-81-171-27-108-155-95-86-7-28-64-114-58-116-162-192-93-16"
109,217055,100,164717,381772,"185-179-173-177-134-64-172-72-129-82-69-165-67-77-76-54-23-153-150-176-162-13-22-19-183-108-10-70-131-14-85-46-24-151-92-7-164-33-196-32-15-119-90-87-79-6-48-84-83-34-137-8-128-50-21-100-178-190-146-68-26-198-157-93-116-175-106-169-163-102-181-98-65-97-117-123-99-111-45-112-115-36-155-195-42-193-44-121-199-186-149-132-120-47-140-35-144-80-127-28"
110,207735,100,157852,365587,"143-2-37-123-31-56-71-134-63-26-151-88-165-53-98-173-78-38-195-21-192-127-100-158-0-5-29-103-61-196-174-65-59-176-85-94-160-199-3-161-105-126-157-49-48-164-34-198-118-97-76-91-24-79-18-14-183-109-152-42-64-194-96-146-104-179-27-1-51-197-175-144-19-190-72-124-137-33-84-87-41-11-121-93-52-139-40-110-189-129-70-169-138-182-90-114-187-185-4-45"
111,199249,100,148585,347834,"108-2-101-17-131-198-80-66-110-119-169-37-134-6-32-138-51-155-147-143-39-3-59-14-121-159-93-47-68-165-82-144-24-105-118-160-46-161-71-164-141-173-181-153-106-163-92-21-180-70-77-52-199-130-192-98-1-73-88-83-125-42-126-195-97-140-184-191-112-103-35-49-61-152-109-89-78-30-116-107-67-28-150-36-18-186-183-135-56-57-63-25-40-62-20-50-96-162-179-69"
112,209718,100,158454,368172,"9-173-16-30-36-187-74-122-121-123-41-6-183-98-81-170-14-22-186-88-86-145-103-151-108-13-102-31-32-40-147-178-52-196-134-8-0-95-15-27-140-42-152-166-154-96-75-179-78-125-143-161-120-146-43-39-18-93-112-133-4-172-60-117-80-50-35-129-171-49-153-185-184-10-26-53-175-110-195-84-128-17-176-97-45-87-142-48-156-12-90-65-37-149-68-2-3-109-194-58"
113,215396,100,165319,380715,"31-26-171-158-180-45-59-144-190-128-127-107-164-47-173-98-129-136-179-75-114-52-199-185-76-151-104-101-23-162-90-115-186-77-10-35-82-182-145-36-13-54-41-6-0-163-150-50-109-148-126-19-130-71-18-183-55-178-20-86-118-156-100-117-8-159-195-110-15-53-99-170-30-39-157-167-72-135-154-92-184-14-133-46-34-43-17-105-112-63-174-169-87-166-3-25-152-84-193-81"
114,206538,100,157727,364265,"162-191-171-130-117-163-104-6-95-103-72-186-156-108-105-12-88-68-136-193-75-81-102-143-147-151-133-62-21-39-36-166-145-139-140-92-169-90-8-160-20-181-137-43-127-149-174-14-164-122-109-129-192-41-13-55-97-165-116-91-3-157-49-94-111-63-87-0-179-66-9-76-148-173-11-26-146-83-2-159-124-155-86-194-24-188-93-135-18-64-190-58-152-197-37-178-19-16-118-100"
115,216410,100,166151,382561,"192-101-128-87-70-112-94-80-166-9-102-105-135-22-51-190-27-197-63-134-123-103-0-142-50-148-46-165-193-41-174-137-194-19-150-24-152-72-42-92-199-54-40-175-177-23-6-162-16-136-181-115-100-8-74-36-39-133-82-139-106-31-121-66-168-73-153-138-21-108-2-53-95-191-15-84-172-7-64-56-129-4-143-55-151-111-47-85-49-79-127-43-173-52-35-182-104-157-189-164"
116,208620,100,156164,364784,"103-194-154-100-181-18-163-101-112-151-74-23-164-50-158-51-134-36-97-67-16-64-176-149-26-131-153-7-168-137-82-166-182-123-141-13-80-47-53-106-5-44-189-35-115-145-40-46-193-71-162-105-167-161-169-132-147-69-68-122-91-111-25-38-10-98-27-157-8-30-6-120-52-94-174-72-93-31-199-2-49-150-89-54-56-17-9-104-198-110-75-173-129-14-109-99-187-90-42-19"
117,193701,100,146772,340473,"150-155-122-130-57-74-152-21-126-189-143-66-192-199-156-54-133-78-160-47-142-0-145-198-25-168-99-134-53-23-140-22-176-9-120-31-82-179-80-112-186-102-27-73-147-75-125-85-105-3-67-132-72-13-187-184-153-76-37-138-191-81-104-51-60-89-141-77-55-4-83-19-70-69-5-2-131-90-59-149-181-58-177-175-165-30-157-7-163-12-45-173-33-68-135-127-188-171-63-43"
118,226579,100,176665,403244,"63-197-116-144-182-112-105-71-35-85-39-193-104-0-128-163-123-161-138-170-32-55-62-20-77-110-115-76-17-42-18-68-118-26-72-148-190-156-45-125-186-168-95-47-199-91-140-177-22-187-98-154-10-121-106-142-16-57-30-60-194-67-69-132-178-129-188-131-88-59-149-8-185-198-179-171-167-87-184-119-83-5-40-174-82-29-44-114-73-102-147-2-176-157-34-75-117-13-48-164"
119,215247,100,169279,384526,"26-56-80-50-133-66-158-148-64-99-23-185-82-163-5-177-16-97-44-87-71-90-128-43-188-154-183-122-38-150-94-186-125-179-8-36-47-1-115-78-51-165-121-117-83-136-28-60-146-46-199-160-123-37-25-198-96-33-114-88-187-14-149-103-134-102-18-151-113-196-52-157-131-95-20-75-194-175-70-104-35-141-42-98-7-2-145-107-190-4-48-120-79-152-30-144-29-139-77-182"
120,212586,100,159547,372133,"195-81-119-150-50-89-58-9-149-48-98-35-136-22-156-138-3-28-139-23-106-47-49-199-18-115-44-46-137-6-86-11-57-37-130-88-96-148-189-102-154-170-147-123-25-104-116-151-196-134-145-82-87-39-91-192-62-97-15-84-181-142-68-153-67-52-26-164-109-17-74-114-83-78-141-93-191-131-152-128-51-161-155-126-34-143-107-188-71-79-76-190-32-60-31-30-179-182-19-125"
121,222455,100,168578,391033,"160-50-95-65-106-88-122-70-64-131-123-156-3-164-56-30-0-159-14-197-31-43-48-178-109-116-79-169-92-100-62-132-115-99-9-188-108-61-172-53-158-41-78-110-85-148-73-18-96-24-185-142-171-35-45-168-180-46-143-76-140-52-83-157-119-107-120-93-130-4-20-12-103-91-86-133-155-139-72-114-196-68-154-98-28-137-23-175-189-170-146-136-40-112-102-39-69-176-153-126"
122,230472,100,179411,409883,"192-46-174-196-89-100-112-153-31-74-24-23-53-195-145-92-199-48-10-164-159-59-128-152-180-116-161-122-70-47-131-175-86-39-177-193-65-63-45-114-38-151-20-44-104-134-62-73-19-17-14-2-37-102-182-101-176-96-52-41-141-118-133-140-129-130-3-60-194-71-66-127-136-88-103-13-190-22-35-146-9-98-166-165-87-94-64-16-42-99-106-155-83-120-167-160-55-173-178-124"
123,205736,100,156775,362511,"199-108-159-81-143-40-111-195-177-173-117-55-192-118-10-65-178-188-109-113-187-92-9-69-54-185-122-91-179-125-73-104-39-126-32-97-44-140-88-22-53-180-161-172-93-29-58-141-160-151-190-80-182-20-167-134-136-27-35-149-30-154-171-48-155-16-142-165-145-15-148-18-170-25-64-128-74-156-168-79-49-86-7-150-137-131-46-169-52-33-5-112-121-102-133-98-72-28-14-43"
124,205228,100,157166,362394,"143-60-54-91-168-186-158-181-70-41-183-113-22-90-81-112-79-126-122-190-94-42-136-37-176-150-30-115-74-155-93-83-116-132-97-121-17-108-120-72-199-6-82-119-99-85-10-152-135-171-114-104-106-33-23-146-138-80-65-194-95-53-107-118-105-27-153-177-51-47-58-5-43-84-184-29-193-35-25-78-130-49-156-191-71-7-198-179-182-172-110-19-98-140-148-48-174-18-141-170"
125,205227,100,159517,364744,"20-105-95-81-120-198-138-47-30-91-132-82-6-170-67-124-164-146-153-71-90-18-94-32-140-15-168-109-86-165-174-83-123-177-131-43-116-176-189-96-103-169-68-38-72-31-127-161-155-154-167-156-41-8-100-106-0-136-10-181-5-92-126-63-197-42-73-182-1-62-157-122-60-129-3-150-135-115-144-40-21-29-112-179-194-11-89-195-196-178-7-104-28-2-143-39-50-111-152-87"
126,209502,100,160348,369850,"25-46-155-65-191-31-184-110-196-77-69-149-51-85-103-105-137-83-8-162-163-74-104-199-17-13-80-94-146-161-56-64-126-117-172-160-132-143-79-156-23-66-15-19-183-148-139-75-141-108-38-158-58-181-91-120-159-53-35-62-178-106-52-68-29-169-129-18-121-190-151-114-118-128-187-21-12-55-90-171-99-125-27-63-26-81-101-86-130-168-34-150-59-180-131-5-82-167-78-109"
127,205334,100,158079,363413,"195-154-191-109-66-4-61-8-32-161-188-196-100-81-6-124-174-187-91-164-193-170-95-146-148-56-192-136-163-143-176-128-36-86-26-160-190-198-113-103-92-169-40-118-31-77-182-194-73-151-141-121-132-111-102-55-72-5-158-52-57-114-18-99-30-34-142-199-64-179-197-167-177-105-126-2-133-162-138-60-62-101-45-49-50-69-106-116-23-46-27-51-9-25-119-145-53-107-12-104"
128,220425,100,168576,389001,"45-107-142-97-85-193-18-11-134-68-106-88-155-117-30-60-23-150-171-1-136-156-122-21-192-67-157-26-42-144-91-102-63-163-87-100-184-3-62-151-165-196-153-76-16-32-47-174-14-98-9-28-99-57-31-113-187-24-130-54-79-129-37-194-175-182-96-89-19-7-164-53-75-77-80-172-90-78-17-12-197-159-52-147-22-190-128-108-6-167-139-140-185-149-61-33-112-49-123-2"
129,221052,100,170755,391807,"185-104-79-43-41-188-189-174-157-144-179-136-101-85-70-53-139-9-146-32-54-8-51-143-36-125-47-40-18-178-169-10-159-111-177-142-71-49-181-77-134-110-19-27-156-55-108-170-109-11-52-176-74-72-78-48-118-152-64-88-195-141-161-117-193-140-98-119-186-120-16-1-59-28-187-107-194-58-147-34-196-66-198-94-100-115-151-17-162-37-180-103-65-4-171-26-38-24-90-82"
130,214548,100,164904,379452,"154-110-153-8-80-93-111-197-105-60-134-19-106-85-96-55-47-112-15-142-100-24-53-143-79-149-32-98-107-198-124-193-167-13-12-199-58-64-109-71-118-113-1-91-65-194-155-188-132-119-163-176-141-157-103-83-95-161-173-120-138-30-140-129-131-159-68-76-130-31-166-72-0-92-77-192-184-137-33-108-195-14-190-7-11-150-87-74-196-78-183-35-52-175-28-51-90-59-70-18"
131,221842,100,169348,391190,"14-70-66-193-119-20-149-85-145-42-133-176-27-155-58-113-181-62-17-6-86-195-80-180-92-25-143-148-76-171-102-77-111-139-24-152-136-3-56-192-46-97-71-182-107-165-50-1-93-15-12-130-101-16-179-183-160-188-150-189-128-196-105-108-39-114-82-156-69-186-185-41-32-131-68-37-125-4-162-144-146-13-194-151-197-163-23-157-0-30-29-98-45-172-89-187-67-53-168-99"
132,214451,100,161533,375984,"89-106-26-145-84-65-75-27-100-34-85-176-182-159-67-15-7-144-152-107-43-137-131-3-183-63-38-105-9-148-178-126-132-71-18-170-120-17-116-139-4-68-156-31-115-169-52-94-161-142-30-41-66-76-124-165-64-47-39-185-82-189-166-195-97-24-93-153-56-160-194-164-110-133-173-155-16-177-88-19-46-192-134-150-72-59-92-103-113-96-23-138-146-114-174-199-119-91-44-36"
133,211273,100,159037,370310,"145-147-161-149-56-104-99-76-23-69-68-160-64-131-30-97-45-71-168-190-92-84-77-185-144-153-163-31-123-172-14-78-143-53-128-22-105-26-65-169-32-24-187-2-86-189-79-93-100-5-11-199-137-167-17-87-120-27-61-66-29-96-152-166-114-125-158-48-136-194-3-8-112-75-50-175-157-85-33-89-90-7-94-180-151-106-43-130-81-173-164-132-67-58-139-118-62-52-38-126"
134,218657,100,167370,386027,"15-114-148-51-64-28-41-187-24-47-18-82-17-23-105-115-142-119-195-127-8-11-79-181-184-106-69-57-104-58-179-141-86-33-96-113-44-92-2-4-149-135-160-100-159-7-14-154-34-54-144-99-190-65-169-110-180-120-55-128-130-94-183-156-27-21-83-164-103-85-186-174-165-161-39-112-38-66-90-173-136-132-46-196-155-49-107-101-147-5-102-32-19-177-91-185-29-172-72-125"
135,207769,100,158340,366109,"129-94-137-7-192-69-64-190-50-166-89-57-124-26-148-112-28-32-76-43-12-111-72-152-11-97-24-125-142-126-114-73-117-160-162-169-9-1-113-177-44-115-168-67-78-92-10-149-128-25-179-102-21-55-188-185-122-105-191-134-130-77-16-199-153-159-93-167-70-19-30-63-150-91-197-139-66-31-163-41-56-173-156-110-33-144-37-109-0-14-71-182-176-121-79-49-51-81-175-88"
136,238893,100,186467,425360,"102-125-3-49-38-70-50-175-115-100-47-172-123-56-62-173-118-151-51-31-2-113-193-29-184-13-186-54-59-109-122-130-188-14-144-42-114-105-166-68-149-169-196-154-171-65-146-150-37-180-5-177-32-11-167-176-183-91-46-72-156-124-178-12-82-89-155-1-140-24-127-132-52-84-93-179-191-189-88-99-162-121-28-181-17-26-197-15-81-161-185-16-128-67-75-145-147-41-44-199"
137,209820,100,157625,367445,"94-62-128-170-68-76-14-52-99-9-164-5-55-26-98-109-10-78-85-73-30-146-110-156-157-33-151-123-122-57-126-21-35-183-188-150-15-71-148-160-53-158-162-199-192-70-39-185-180-89-193-100-130-34-72-95-45-178-129-174-42-77-16-101-79-59-84-1-51-50-91-65-175-43-115-64-168-25-54-38-138-56-172-177-97-139-44-184-58-92-31-190-93-81-189-29-90-3-27-88"
138,191057,100,138243,329300,"34-66-195-69-188-85-136-129-8-21-117-112-17-120-191-24-46-105-6-122-126-60-32-164-198-111-94-38-100-42-70-88-181-54-125-123-18-183-137-63-72-178-81-165-98-141-15-65-23-73-133-172-127-168-75-58-97-45-5-197-59-154-1-151-78-82-135-116-193-35-3-128-159-163-118-130-43-138-39-12-10-31-171-44-87-64-49-173-91-67-92-0-132-93-79-14-95-13-53-4"
139,215240,100,165880,381120,"39-72-181-111-26-149-156-191-131-132-52-17-152-185-190-48-180-94-55-133-157-0-148-135-188-31-36-18-103-150-151-167-21-143-12-28-53-71-25-99-32-159-87-189-3-164-2-51-176-106-154-102-123-126-120-23-78-98-137-74-125-197-145-77-127-35-144-7-89-182-160-192-116-59-11-117-24-38-44-184-75-5-82-198-14-130-134-187-34-54-49-10-27-136-47-196-88-166-62-108"
140,199273,100,152207,351480,"132-34-185-126-122-25-17-142-0-153-168-129-5-60-136-175-145-72-28-131-134-191-96-70-68-123-108-4-30-73-114-29-147-65-167-178-84-40-172-183-98-112-43-198-27-130-139-138-166-154-186-88-133-26-36-11-104-143-89-79-137-190-42-111-95-199-21-118-10-38-86-124-103-67-161-113-187-46-152-15-157-197-169-189-58-31-177-49-117-150-105-144-12-50-195-9-75-2-194-119"
141,228376,100,175543,403919,"96-174-55-14-121-101-177-124-17-85-50-187-98-66-182-172-162-1-161-192-53-198-156-179-168-186-84-56-129-140-191-163-130-26-158-38-178-30-126-110-47-68-188-7-46-136-122-3-196-150-131-194-69-52-99-197-176-103-146-71-33-73-6-183-22-72-42-165-125-89-8-154-120-166-0-10-97-105-116-180-57-63-181-185-78-102-118-113-37-184-60-135-48-141-137-44-51-31-45-79"
142,216237,100,163593,379830,"3-173-150-23-26-161-41-163-29-11-95-199-149-172-174-128-115-159-111-113-14-154-51-58-5-80-179-189-7-192-81-8-167-15-65-145-42-39-119-60-164-169-126-166-186-37-105-94-45-50-93-31-54-123-184-79-129-30-127-190-158-48-107-183-16-104-116-53-96-130-176-87-63-59-4-49-28-52-187-36-68-103-106-22-160-185-108-74-143-86-178-34-141-6-35-101-102-92-146-171"
143,202646,100,157013,359659,"137-183-19-164-35-126-140-32-58-69-145-179-3-80-193-184-77-125-150-169-153-30-109-90-72-162-174-82-63-86-154-89-60-97-96-22-62-66-59-40-24-4-56-177-61-156-33-195-74-189-166-54-14-37-136-70-168-180-141-117-106-75-41-176-113-133-181-161-78-103-29-144-95-34-158-65-157-129-127-151-152-131-21-45-98-122-107-26-50-28-130-85-67-196-99-91-115-192-182-73"
144,205306,100,159737,365043,"73-137-157-105-89-186-4-123-120-150-179-109-108-3-149-88-27-19-141-169-167-168-176-94-170-55-199-139-144-21-80-0-146-43-1-5-38-191-36-104-148-193-131-166-33-91-66-103-37-12-173-190-45-140-182-122-188-121-9-31-62-159-152-65-76-78-51-68-8-47-58-83-165-6-142-172-118-28-145-111-41-160-171-102-22-74-34-161-187-90-7-143-16-48-57-30-84-180-113-155"
145,213960,100,162298,376258,"167-69-136-133-161-94-95-98-196-34-35-64-93-61-173-18-187-146-106-41-89-45-177-122-192-75-111-185-102-7-97-175-131-147-0-110-197-183-101-5-68-71-28-72-12-121-145-119-23-149-91-10-181-109-85-152-170-158-22-137-51-112-65-84-87-140-178-78-100-33-16-116-99-113-164-198-37-44-30-49-63-60-193-42-47-57-151-163-195-15-59-150-174-11-180-83-124-46-130-172"
146,220220,100,171165,391385,"31-98-72-54-169-25-187-100-107-87-121-178-128-120-35-28-132-177-5-52-109-173-92-38-197-60-69-62-123-90-95-171-17-122-64-84-188-89-142-37-166-184-13-59-150-46-126-185-179-124-55-144-88-32-137-10-6-172-164-196-83-161-2-149-30-86-99-145-156-77-199-193-140-66-154-191-7-97-152-117-165-33-34-65-189-136-44-103-135-127-71-112-114-81-195-15-133-119-96-50"
147,202683,100,151061,353744,"119-11-42-198-97-39-134-169-117-138-66-180-25-106-37-178-81-130-62-186-122-140-194-173-60-4-170-160-45-127-6-76-65-22-75-52-195-68-43-171-28-154-115-125-191-159-177-12-121-24-96-21-152-166-13-146-189-151-105-120-2-188-92-99-74-67-98-148-36-110-9-101-131-70-190-104-168-40-108-123-77-44-18-181-10-157-142-103-64-163-63-139-116-126-46-15-165-112-164-55"
148,197565,100,148572,346137,"51-139-190-126-31-185-160-85-35-188-175-171-116-21-89-127-156-198-32-114-25-69-86-14-50-71-176-58-76-182-131-17-6-91-106-8-57-73-20-23-70-174-83-29-95-195-167-59-103-183-140-157-78-147-102-4-186-47-104-192-189-24-10-170-92-7-64-136-18-173-62-110-109-133-177-34-49-107-5-162-56-135-68-118-66-179-120-16-52-154-172-119-33-191-84-88-145-63-72-151"
149,212910,100,160791,373701,"23-80-125-12-75-85-132-191-187-40-77-61-156-179-3-96-15-10-174-66-115-44-193-46-184-64-56-182-128-176-65-150-81-112-107-190-163-48-89-108-135-14-92-123-158-104-82-161-160-63-18-165-134-175-58-6-68-19-35-11-74-95-70-183-29-137-170-185-194-59-196-49-164-67-7-98-27-26-140-127-154-99-178-118-88-172-41-117-110-103-142-17-186-144-30-100-51-106-171-42"
150,203251,100,150221,353472,"168-58-39-196-6-166-60-38-13-12-181-47-56-121-83-99-45-174-148-0-86-124-1-40-96-186-135-63-18-68-94-52-28-144-21-74-62-134-173-142-147-46-53-123-78-95-17-75-15-178-130-91-49-22-19-111-129-194-199-20-192-156-67-48-146-36-65-50-76-101-162-160-11-85-71-87-164-80-34-26-14-125-169-84-103-171-51-172-118-100-107-188-104-197-193-151-41-2-116-115"
151,214349,100,167983,382332,"22-30-28-51-65-131-106-98-163-1-40-134-80-68-127-15-35-183-155-159-88-83-122-129-140-161-6-182-164-179-185-171-193-114-188-47-130-10-177-0-19-56-12-94-32-157-25-93-42-39-17-128-70-60-5-46-190-67-138-82-109-64-78-126-81-13-162-29-14-69-4-61-101-148-198-156-86-168-31-53-135-104-120-96-9-59-107-116-121-170-176-150-137-23-57-38-27-36-74-154"
152,206373,100,156044,362417,"40-39-169-98-122-7-23-35-176-29-142-121-114-27-1-58-187-57-30-6-26-129-93-144-140-194-52-191-94-70-164-141-64-53-69-88-45-116-134-125-100-73-180-13-104-177-192-51-105-136-20-107-126-48-185-130-47-193-160-151-76-75-5-138-115-43-17-24-33-80-62-89-173-196-32-156-197-188-190-163-183-133-10-101-120-12-178-50-112-34-82-110-128-186-108-170-81-99-28-97"
153,204943,100,152094,357037,"3-150-186-140-28-117-32-48-76-57-110-128-197-112-120-80-65-115-82-188-67-85-189-177-134-121-23-7-42-103-173-22-34-155-108-111-127-15-61-12-139-182-185-68-9-53-190-180-77-43-98-169-25-116-123-84-99-51-159-144-38-79-41-131-92-193-44-91-69-14-31-161-126-18-119-178-142-129-21-89-196-137-88-107-170-4-55-29-118-141-192-90-16-199-19-73-130-5-70-87"
154,197523,100,152309,349832,"37-122-113-128-172-170-38-117-7-138-99-148-93-41-46-175-57-185-72-79-20-4-71-78-14-159-70-34-126-193-95-62-142-91-103-109-135-67-156-145-130-182-105-152-104-82-123-89-192-188-171-11-165-168-143-94-139-32-187-56-33-31-158-26-112-140-124-98-164-191-106-183-155-76-36-84-85-125-153-136-52-173-197-77-19-83-43-149-61-73-74-3-100-17-97-0-29-47-166-54"
155,222365,100,171549,393914,"189-160-142-17-188-6-50-5-105-64-7-37-185-28-54-110-82-68-199-9-44-193-178-114-74-40-128-80-152-157-129-61-33-140-112-172-167-190-83-104-176-133-186-115-81-136-18-192-125-148-26-175-42-144-77-25-22-134-99-88-146-48-159-101-95-11-63-84-138-56-20-113-75-132-164-198-14-166-2-39-117-16-108-184-4-120-179-126-194-66-8-154-109-170-30-43-79-107-103-38"
156,203891,100,150826,354717,"137-99-188-162-115-32-77-84-184-131-34-13-121-125-80-134-151-78-135-6-79-116-73-85-44-2-160-141-48-68-167-130-195-69-57-45-136-103-128-92-198-71-28-29-177-110-186-23-108-43-144-169-119-46-170-199-38-191-30-21-187-14-100-17-133-189-152-35-102-58-15-11-74-168-91-173-149-109-181-64-55-124-171-9-174-190-59-185-161-154-81-193-1-118-31-52-87-72-76-27"
157,229130,100,176151,405281,"97-130-103-184-27-48-126-63-57-53-162-2-30-61-75-102-50-33-26-68-96-172-180-188-118-89-198-179-108-24-187-150-151-164-183-69-94-1-189-141-52-131-169-28-117-65-60-101-9-82-193-181-194-191-91-88-85-13-153-100-147-87-177-104-122-163-80-8-19-90-83-64-34-129-133-110-76-142-41-12-192-56-158-135-156-10-120-31-73-46-168-45-14-23-36-199-173-37-165-42"
158,217511,100,161828,379339,"83-130-131-124-11-102-85-96-8-93-48-1-137-36-57-139-147-192-177-146-49-95-14-68-28-143-47-105-134-101-2-181-170-27-13-70-38-125-51-183-55-195-24-56-191-123-160-71-34-199-89-104-52-150-59-100-187-16-136-197-82-61-97-163-138-106-186-118-120-12-88-58-91-22-73-4-122-84-10-41-178-172-149-37-185-69-180-194-46-189-158-148-110-67-72-30-9-184-66-171"
159,221223,100,171180,392403,"190-94-119-93-116-46-48-13-145-143-14-35-22-15-1-137-167-7-70-54-188-65-120-71-6-52-57-49-28-162-55-191-171-160-140-66-133-173-16-39-90-18-8-152-148-130-4-11-17-53-107-83-174-183-176-132-151-2-104-101-72-164-97-73-136-60-27-59-199-100-124-96-194-146-149-56-165-192-166-182-80-21-109-103-170-3-89-161-44-25-121-110-91-105-179-129-112-88-189-40"
160,206356,100,155497,361853,"60-35-119-63-41-14-108-59-7-193-150-28-69-51-54-74-20-159-55-180-92-31-138-163-154-147-32-58-57-29-6-148-86-95-168-112-155-101-66-142-131-46-48-170-79-140-143-8-183-126-17-50-42-1-133-44-27-94-149-23-184-115-135-104-106-105-43-158-141-81-172-68-21-10-167-89-37-174-166-129-118-181-197-171-13-96-98-186-36-185-152-127-15-107-178-33-52-100-196-61"
161,213220,100,161844,375064,"58-148-12-13-180-173-65-73-7-38-134-55-108-122-57-143-72-83-89-84-54-193-33-107-164-182-4-97-177-129-29-168-183-87-90-131-88-186-64-79-119-144-196-169-161-19-115-94-15-21-120-56-156-80-82-124-43-158-98-92-48-53-24-22-67-91-103-70-2-75-126-99-34-35-104-11-116-167-159-113-114-25-198-188-185-42-195-187-194-18-26-51-132-68-184-162-66-40-76-85"
162,217882,100,170729,388611,"168-173-114-48-97-60-183-110-87-136-34-126-59-155-61-0-83-179-182-81-193-68-138-52-178-129-92-132-43-145-11-4-152-100-90-95-22-106-63-140-94-104-105-70-30-176-46-98-111-40-154-134-26-163-15-101-35-74-118-13-80-148-44-88-33-107-24-162-67-137-91-125-76-103-186-199-171-170-96-194-58-62-78-53-31-195-84-116-66-180-86-131-29-25-130-122-99-50-8-187"
163,202933,100,153614,356547,"133-77-162-169-157-198-136-31-4-100-180-51-40-50-103-93-154-147-195-192-27-14-179-83-20-34-172-37-125-60-17-197-73-66-99-53-0-142-97-166-35-161-47-2-42-75-177-150-127-146-11-54-159-149-181-178-39-156-85-168-76-26-9-145-130-174-104-78-80-24-123-140-59-67-111-84-160-108-122-61-138-165-63-114-148-46-91-36-70-94-185-88-29-56-81-8-58-102-96-128"
164,214847,100,163702,378549,"102-183-113-165-178-108-101-110-23-38-168-124-154-197-74-39-150-67-48-96-176-190-112-2-141-153-93-119-29-152-76-73-36-56-134-71-104-65-131-64-120-44-163-0-140-184-51-32-122-94-46-128-146-14-144-133-72-15-164-199-195-105-1-169-129-192-180-127-30-196-98-63-42-62-59-3-69-111-20-159-125-95-5-16-132-145-66-167-107-148-50-83-4-99-82-174-155-137-61-166"
165,230418,100,179211,409629,"111-56-117-140-106-122-75-15-184-112-18-123-52-153-178-40-66-71-127-92-121-36-41-93-126-60-37-110-174-24-94-171-139-138-191-114-10-29-190-32-4-62-147-44-185-3-105-27-73-165-42-129-2-101-179-20-109-155-124-25-86-192-151-167-90-72-47-76-84-65-39-156-175-103-85-133-7-53-34-169-146-160-45-88-0-116-59-23-168-199-158-17-186-125-46-130-119-9-19-26"
166,228925,100,183589,412514,"58-121-98-28-158-166-149-168-82-183-49-196-64-89-169-136-43-11-142-159-94-96-86-148-174-37-122-177-71-47-10-100-3-40-2-83-16-93-184-187-67-140-48-152-190-4-129-8-199-101-127-60-141-84-135-34-42-117-70-75-87-80-180-78-6-18-81-160-26-197-179-112-27-157-95-176-115-143-165-124-65-189-108-161-1-88-30-171-33-131-61-59-54-44-185-20-198-45-97-5"
167,223487,100,175052,398539,"189-111-19-35-106-155-123-38-190-192-49-143-157-175-65-80-8-108-69-22-90-118-67-46-54-4-42-91-59-87-164-170-171-40-6-185-121-64-27-18-104-114-1-43-178-98-32-179-86-2-128-85-13-51-23-120-60-50-125-20-3-160-83-107-135-193-172-196-156-53-66-140-28-33-122-180-70-92-186-110-174-132-89-130-136-9-134-124-24-62-81-199-57-112-94-15-187-34-101-184"
168,215014,100,163023,378037,"58-4-25-100-160-22-78-125-47-52-144-129-48-157-91-164-74-166-152-83-68-138-50-190-163-106-135-39-154-165-184-119-97-88-93-115-117-72-161-104-76-61-75-126-51-136-180-30-1-85-10-188-81-2-186-13-96-149-118-87-18-84-40-193-70-55-80-159-17-62-73-21-26-105-56-107-7-151-24-171-82-121-112-89-131-181-37-139-140-194-29-20-44-127-196-5-11-142-137-124"
169,216378,100,167554,383932,"69-119-92-145-183-2-121-102-0-112-67-100-21-168-91-66-73-26-72-93-184-111-1-173-136-135-199-81-16-58-117-6-164-130-57-36-179-162-165-98-95-191-194-169-23-166-35-17-25-18-45-46-14-43-158-56-177-129-171-65-126-132-7-24-180-106-123-70-31-186-62-138-157-71-4-147-34-28-122-153-10-90-87-27-74-141-196-84-97-52-187-160-176-189-163-125-133-49-104-94"
170,214155,100,162544,376699,"27-191-192-25-126-197-119-88-17-141-85-186-190-83-62-144-105-110-173-72-134-199-54-24-101-77-160-3-53-29-196-1-59-120-48-28-42-35-50-179-137-152-158-194-79-147-133-39-130-75-182-41-56-82-195-21-14-143-67-106-40-78-97-68-178-146-183-23-36-107-26-58-69-9-135-103-140-159-114-115-150-177-102-45-104-124-148-31-33-20-95-7-109-142-136-112-96-71-174-111"
171,223714,100,175309,399023,"18-141-1-136-128-119-115-65-180-161-106-171-185-142-76-160-107-155-176-68-113-120-34-173-164-140-52-12-37-103-102-175-72-60-54-193-199-91-59-33-89-154-42-167-92-81-121-178-134-94-2-169-133-111-194-152-132-88-108-97-56-122-135-184-123-110-6-137-3-69-117-29-124-146-85-8-181-13-162-53-83-73-31-15-67-153-148-93-98-21-47-87-151-190-197-55-71-61-84-114"
172,224805,100,173921,398726,"35-104-93-156-84-142-199-106-113-126-197-169-63-30-118-121-120-89-192-163-19-66-49-195-75-141-98-23-160-15-58-186-69-112-20-44-82-60-85-188-16-52-42-105-116-103-40-57-167-150-67-92-129-119-143-144-185-191-170-64-146-83-165-124-183-56-152-2-48-38-176-62-76-172-31-46-94-47-90-53-8-39-88-11-110-73-137-9-108-115-153-18-173-25-28-34-140-3-81-97"
173,207526,100,157533,365059,"39-99-123-78-129-151-106-30-80-181-20-24-102-21-73-22-94-162-133-53-18-125-69-1-121-170-179-14-75-76-174-97-152-6-128-175-189-117-111-145-95-34-163-88-3-166-44-147-161-36-41-157-110-72-169-144-77-113-93-64-32-50-196-115-0-57-25-135-136-29-55-107-184-51-193-105-192-160-139-13-31-12-4-142-70-155-199-182-9-119-52-186-96-118-176-134-58-191-167-148"
174,203420,100,155096,358516,"36-29-174-91-30-9-77-151-103-109-166-8-126-175-157-35-131-177-136-102-121-124-42-69-134-153-95-181-99-184-156-25-4-163-10-6-162-130-20-100-145-120-13-58-119-106-0-7-105-125-28-135-123-38-164-26-81-110-143-51-179-53-173-128-137-22-57-16-79-138-165-72-111-160-83-45-41-67-19-118-127-148-114-144-60-150-40-108-14-122-17-33-92-158-63-32-54-85-149-93"
175,206741,100,158999,365740,"32-123-51-173-30-140-23-144-157-89-192-11-41-70-161-94-45-80-62-136-166-95-40-190-149-72-183-198-134-155-58-48-82-137-169-108-98-135-24-199-146-69-175-3-16-156-90-182-126-46-141-38-167-114-164-13-15-168-154-57-28-35-27-127-139-49-181-68-177-162-128-0-9-185-180-78-34-153-14-197-107-88-116-22-194-12-84-131-87-151-170-17-158-138-145-54-1-119-77-187"
176,205058,100,157171,362229,"127-59-144-121-39-3-186-130-119-142-57-128-76-0-24-19-124-82-11-178-36-136-21-176-148-93-114-88-196-1-163-139-185-109-146-123-120-75-7-69-54-152-195-28-49-98-74-2-80-135-63-48-46-95-32-118-17-72-102-89-107-92-177-106-100-184-41-34-161-16-143-179-166-103-141-15-194-164-174-165-150-145-85-61-168-91-126-10-77-104-155-40-181-160-20-188-198-81-67-129"
177,218405,100,169920,388325,"135-71-194-112-161-108-55-10-17-137-120-28-171-61-38-66-190-51-53-188-21-143-134-90-169-150-148-197-166-59-23-72-33-56-80-69-1-16-20-57-114-36-141-24-14-187-60-22-107-34-76-199-4-123-192-182-165-25-104-43-77-52-0-130-117-64-131-97-186-109-8-178-101-86-12-27-149-88-157-153-70-75-41-13-99-155-68-118-42-67-191-139-156-89-173-50-32-63-195-73"
178,203670,100,155701,359371,"118-86-59-63-90-8-143-192-18-145-11-160-33-124-190-156-99-76-16-7-138-19-170-146-69-184-73-127-104-178-144-102-130-35-107-123-6-149-89-17-105-50-22-92-70-197-121-85-53-40-78-103-62-172-150-177-37-36-51-137-165-162-193-158-42-39-93-55-113-20-24-74-174-134-58-120-199-176-119-186-21-96-122-109-141-87-23-0-153-12-166-13-191-111-152-179-43-142-2-44"
179,213354,100,164661,378015,"60-199-170-30-68-50-102-74-64-197-135-49-91-73-19-1-14-154-42-97-117-111-12-172-85-16-2-193-21-155-179-37-25-90-46-45-183-146-10-150-98-20-29-166-62-188-120-55-32-106-65-56-57-174-149-13-141-78-128-34-181-156-18-72-137-104-140-83-195-31-189-76-133-67-110-36-138-26-51-8-114-84-23-139-124-136-143-147-116-148-175-123-105-168-28-71-194-5-43-77"
180,213273,100,165603,378876,"114-176-159-172-108-18-112-141-47-116-161-169-165-52-182-11-170-9-144-29-130-154-86-57-125-71-151-152-42-190-83-135-173-44-91-183-126-63-129-40-117-142-189-180-155-145-37-118-34-89-198-113-177-119-143-23-10-127-178-199-153-187-184-15-17-122-171-106-156-134-115-6-62-7-194-179-67-188-35-13-50-75-74-48-61-49-80-157-160-38-76-72-101-174-96-21-70-45-14-69"
181,224194,100,175738,399932,"45-101-195-162-27-23-14-28-151-197-148-29-113-132-97-107-150-6-71-133-89-44-141-55-163-0-109-30-43-174-2-68-190-130-91-167-176-48-196-168-24-17-93-47-86-182-177-116-87-181-74-98-117-125-26-72-50-142-4-77-21-188-170-102-111-156-57-5-35-155-42-103-114-40-83-105-131-199-1-173-108-115-20-118-138-73-61-84-187-159-185-8-184-79-152-121-160-104-171-38"
182,221341,100,170581,391922,"57-81-93-94-63-96-150-174-56-31-19-124-194-149-20-135-161-24-61-30-120-110-89-109-128-133-23-113-188-22-37-107-144-164-190-39-32-186-97-18-191-86-71-141-166-83-41-65-100-173-184-84-99-189-46-1-78-134-117-101-108-36-198-59-142-185-90-158-153-137-87-146-172-62-77-73-72-105-195-154-43-38-47-123-177-126-152-64-2-119-13-11-26-112-4-162-104-114-121-7"
183,223504,100,173630,397134,"98-149-151-158-92-129-82-32-55-68-107-57-46-56-4-173-20-40-51-77-179-80-140-31-156-67-44-63-0-62-104-154-22-181-19-128-23-183-103-37-90-28-144-166-163-175-27-195-191-78-69-141-134-97-9-199-136-192-189-115-34-147-108-111-76-84-172-88-139-135-157-127-150-120-79-177-159-117-1-148-41-43-2-70-146-193-75-66-197-198-116-30-59-71-18-10-122-162-15-165"
184,214370,100,161580,375950,"111-172-100-104-32-118-112-10-8-199-90-95-146-170-178-142-76-9-62-83-191-41-51-45-126-36-34-173-30-192-42-185-50-49-165-12-197-48-137-22-72-29-168-160-4-193-61-89-156-96-11-52-33-47-190-174-122-85-79-184-31-162-155-99-176-186-138-28-124-2-46-43-150-64-14-38-106-147-87-81-196-24-78-115-39-77-92-182-0-127-88-105-67-149-35-56-175-68-180-167"
185,220864,100,168340,389204,"81-117-11-130-68-174-136-139-178-118-111-169-197-89-72-97-151-177-9-124-98-54-62-37-51-12-2-183-108-70-146-64-148-67-195-69-194-131-50-104-55-157-158-140-189-47-141-86-65-1-16-88-43-61-14-172-66-40-107-78-119-92-100-35-159-115-8-41-144-193-196-120-179-156-48-39-152-25-79-198-149-171-101-132-135-22-53-58-63-44-15-0-160-38-56-102-129-17-26-123"
186,204649,100,157271,361920,"57-116-147-145-180-73-12-134-109-54-79-60-89-63-29-15-43-107-188-170-91-5-179-74-30-186-183-31-49-46-52-55-80-47-82-11-162-85-1-25-148-127-94-69-18-146-149-48-117-144-26-143-192-132-137-97-68-163-115-20-139-130-56-37-22-83-189-153-184-119-27-34-174-76-92-156-33-44-135-77-175-196-66-154-99-95-101-103-28-185-9-123-65-114-187-32-191-42-24-86"
187,212166,100,163473,375639,"9-160-36-194-13-70-54-17-10-43-111-85-134-46-130-37-42-183-118-2-148-178-121-20-146-32-132-12-150-193-123-174-78-27-112-120-53-47-16-157-181-29-149-23-52-94-145-173-98-131-137-19-168-22-102-166-58-138-142-7-129-39-61-88-90-187-198-45-33-26-25-51-169-79-189-106-199-86-65-34-175-62-93-182-80-75-92-97-60-135-133-77-113-91-125-195-6-110-164-8"
188,215558,100,165779,381337,"190-133-15-153-28-95-36-127-81-29-39-101-108-184-80-87-171-25-163-50-151-187-22-43-176-78-42-159-177-72-38-52-68-126-189-160-61-175-172-17-173-73-138-18-199-117-197-105-155-111-64-82-188-65-116-56-156-113-75-134-143-136-129-44-130-94-90-89-0-109-122-57-193-79-40-152-167-157-53-98-142-26-51-97-23-102-123-165-13-70-24-9-181-34-59-146-186-120-86-83"
189,208968,100,157866,366834,"19-141-31-146-71-75-69-45-84-62-44-174-111-136-199-158-46-79-109-12-11-190-4-86-166-175-186-130-195-60-154-145-29-68-49-118-47-48-155-34-90-165-96-99-67-51-159-39-55-181-192-37-63-3-128-50-82-14-172-76-167-173-138-180-139-115-193-36-121-24-32-187-35-88-196-78-98-178-156-198-9-30-160-147-107-127-33-179-140-81-197-119-103-54-120-132-1-6-72-59"
190,203410,100,151027,354437,"146-27-1-107-171-190-135-166-112-142-37-193-160-16-187-41-155-35-194-51-115-149-8-63-61-65-111-83-69-46-116-191-119-25-31-109-15-184-67-197-64-192-58-79-0-24-86-74-175-5-127-88-181-70-113-136-19-129-76-95-151-162-100-3-180-186-196-91-89-102-150-164-110-161-14-29-77-106-48-53-26-177-170-97-42-168-36-6-195-55-167-50-59-132-92-144-11-49-52-189"
191,214905,100,166168,381073,"128-50-144-39-49-57-169-3-7-150-152-0-136-20-5-72-187-26-105-181-83-88-86-168-133-116-174-40-141-91-156-178-79-24-198-134-92-80-149-62-167-132-185-123-135-4-163-166-15-28-16-108-34-13-142-56-186-159-120-65-180-22-176-127-17-37-131-194-45-179-95-184-111-6-175-104-191-117-77-113-75-42-47-46-146-19-63-119-96-78-1-97-129-158-130-30-9-29-89-182"
192,206110,100,156642,362752,"139-151-0-70-53-174-12-146-89-28-183-44-35-8-171-114-103-17-140-3-129-143-149-134-20-46-105-109-100-50-124-160-126-123-83-68-135-196-113-69-54-162-102-187-195-13-118-198-76-23-26-130-73-96-1-91-175-33-186-136-61-153-21-94-157-193-51-43-81-173-101-117-137-180-49-31-65-121-66-159-97-75-92-191-95-115-18-25-176-155-71-119-45-142-40-181-165-77-30-41"
193,235379,100,183012,418391,"159-19-7-179-178-93-83-105-161-130-91-97-108-160-57-85-122-45-164-99-82-28-20-68-165-141-76-53-119-92-112-103-71-199-117-126-115-40-153-27-69-173-43-123-62-65-116-15-33-66-151-88-86-6-30-26-133-49-16-128-81-73-109-169-134-42-177-38-17-137-90-148-37-152-185-107-180-193-111-145-84-3-149-12-9-21-52-96-23-39-132-74-101-170-125-140-64-102-189-70"
194,217782,100,165939,383721,"88-94-72-176-174-193-13-162-95-24-2-184-65-135-178-79-155-148-85-152-159-67-181-44-150-187-145-46-191-105-147-108-100-141-51-172-143-75-177-153-0-196-22-78-186-3-31-127-38-98-146-4-122-6-14-49-7-59-165-71-133-92-180-86-15-170-169-164-16-129-81-82-84-36-57-8-119-52-25-68-89-103-39-144-142-168-151-171-104-74-32-128-138-131-121-194-195-126-73-76"
195,239698,100,185649,425347,"54-108-68-168-49-16-153-142-180-107-137-135-47-115-148-147-79-116-26-167-2-22-196-154-123-17-44-56-18-164-150-166-42-91-193-132-78-130-117-131-191-81-105-70-110-155-187-43-57-46-174-64-72-65-182-55-195-52-11-157-181-41-138-151-13-100-89-179-32-160-88-90-6-124-40-161-8-80-144-199-171-60-102-19-5-53-186-109-172-39-165-173-58-77-35-129-10-112-50-146"
196,215412,100,167025,382437,"56-37-74-190-79-16-153-7-65-193-63-139-92-40-80-118-168-57-174-129-143-141-90-36-12-183-112-3-194-140-105-6-29-127-181-14-67-19-86-196-116-4-24-135-184-125-10-109-154-85-77-166-175-82-111-20-186-144-170-107-11-31-150-113-195-88-25-165-98-34-156-172-151-97-180-199-96-69-66-122-2-62-191-182-188-17-33-128-15-1-81-83-78-126-55-35-22-46-68-42"
197,217790,100,164728,382518,"123-188-16-181-154-195-12-38-132-189-4-108-87-177-75-175-100-96-2-39-199-120-160-114-44-183-106-24-0-162-182-65-172-58-153-80-71-63-105-145-42-50-136-59-43-70-166-88-101-150-165-66-159-76-134-139-152-122-163-85-37-119-54-149-121-98-135-148-184-30-115-13-74-196-72-19-191-48-190-53-156-117-178-97-55-103-112-82-194-128-73-147-84-161-81-126-104-155-14-15"
198,201264,100,155423,356687,"32-147-166-90-155-177-16-135-191-40-49-26-60-21-77-29-18-139-88-110-62-156-3-199-82-118-127-89-121-97-137-109-72-198-163-167-129-171-45-157-78-74-6-186-85-181-28-153-53-178-190-122-120-37-168-41-23-103-187-134-98-182-179-33-104-189-63-34-57-27-86-15-144-185-47-132-50-183-30-195-197-115-105-111-8-96-94-101-169-149-39-99-106-126-93-64-10-42-58-75"
199,230778,100,183038,413816,"32-139-36-165-14-189-110-44-58-88-185-77-61-113-70-41-191-51-35-198-125-115-114-79-84-162-109-112-59-7-17-62-65-100-154-6-180-1-171-18-175-174-8-128-63-46-179-33-132-135-172-5-116-187-118-71-123-137-140-190-119-29-134-176-178-136-122-64-168-74-156-130-121-141-163-102-149-28-3-129-45-55-97-85-181-117-9-147-19-111-49-48-126-108-101-31-169-0-91-37"
200,216919,100,165670,382589,"95-110-140-137-142-52-89-40-176-174-10-147-101-96-168-24-170-57-25-138-59-105-14-158-119-123-195-6-67-38-31-41-12-159-93-113-84-66-17-109-166-36-104-91-73-51-44-5-198-83-48-112-94-141-145-131-115-127-2-53-114-77-103-193-191-46-98-196-15-74-28-178-146-100-129-62-87-61-106-54-22-143-154-163-183-117-27-171-45-97-76-32-70-79-180-18-9-99-120-37"
