SolutionID,TotalCost,NumNodes,TotalDistance,ObjectiveFunction,Cycle
1,51749,100,18657,70406,"0-35-109-29-69-189-155-145-15-3-70-161-188-6-169-132-13-195-168-43-134-139-11-182-138-33-160-144-56-104-8-82-87-21-177-5-45-142-78-175-36-61-91-141-77-97-146-187-165-127-89-103-137-114-113-194-166-52-172-179-185-22-99-130-95-86-183-140-199-9-148-47-66-94-60-20-59-28-149-4-152-170-34-55-18-62-128-124-143-159-106-64-176-180-163-186-153-81-50-111"
2,52023,100,18514,70537,"1-16-27-38-92-63-96-32-135-122-133-10-178-115-147-71-191-90-125-51-98-118-74-134-6-188-169-132-13-70-3-15-145-195-168-43-139-11-29-109-35-0-111-81-153-163-176-106-124-62-18-86-95-130-185-179-166-194-113-103-89-127-165-187-146-77-141-91-61-36-175-78-142-45-5-177-21-82-8-104-144-160-33-138-182-25-158-116-121-112-19-151-54-73-164-31-193-117-198-156"
3,49288,100,20242,69530,"2-139-11-182-138-33-160-144-104-8-82-21-177-5-45-142-78-175-36-61-91-141-77-97-146-187-165-127-89-103-113-194-166-179-185-22-99-130-95-86-183-140-152-170-34-55-18-62-124-106-176-163-153-81-111-0-35-109-29-168-195-145-15-3-70-13-132-169-188-6-147-115-10-133-122-72-107-40-100-63-135-38-27-16-1-156-198-117-193-31-54-151-131-90-191-51-121-118-74-134"
4,50083,100,17572,67655,"3-155-184-170-152-140-183-95-130-22-99-9-199-4-149-28-59-20-60-148-47-94-66-57-172-52-179-185-86-166-194-113-176-180-26-103-114-137-127-89-163-165-187-146-153-81-77-97-141-91-79-61-36-175-78-142-45-5-177-21-87-82-111-144-56-8-104-138-182-139-11-49-33-160-29-0-109-35-143-159-106-124-128-62-18-55-34-189-15-145-195-168-126-13-132-169-6-188-161-70"
5,47550,100,20891,68441,"4-140-183-152-170-34-55-18-62-128-124-106-143-35-109-0-29-160-33-11-134-74-118-121-51-90-131-31-117-1-38-135-63-122-133-10-115-147-6-188-169-132-13-70-3-15-145-195-168-139-182-138-104-8-111-82-21-177-5-45-142-78-175-36-61-91-141-77-81-153-187-163-89-127-137-114-103-26-176-113-194-166-22-99-130-95-86-185-179-172-57-66-94-47-148-60-20-59-28-149"
6,52253,100,19921,72174,"5-177-21-104-138-182-139-168-195-145-15-3-70-161-13-132-169-188-6-192-147-115-10-133-122-72-107-40-100-63-135-38-27-16-1-156-198-117-193-31-73-54-151-19-112-131-125-90-191-120-51-121-118-74-134-11-49-33-160-29-109-35-0-144-111-8-82-58-77-81-153-163-176-106-124-62-18-86-95-130-185-179-166-194-113-103-89-127-165-187-146-97-141-91-61-36-78-175-142-45"
7,49084,100,20332,69416,"6-147-115-10-133-122-72-107-40-100-63-135-38-27-16-1-156-198-117-193-31-54-151-131-90-191-51-121-118-74-134-43-139-11-182-138-33-160-144-104-8-82-21-177-5-45-142-78-175-36-61-91-141-77-97-146-187-165-127-89-103-113-194-166-179-185-22-99-130-95-86-183-140-152-170-34-55-18-62-124-106-176-163-153-81-111-0-35-109-29-168-195-145-15-3-70-13-132-169-188"
8,53033,100,19821,72854,"7-175-78-142-45-5-177-21-104-138-182-139-168-195-145-15-3-70-161-13-132-169-188-6-192-147-115-10-133-122-72-107-40-100-63-135-38-27-16-1-156-198-117-193-31-73-54-151-19-112-131-125-90-191-120-51-121-118-74-134-11-49-33-160-29-109-35-0-144-111-8-82-58-77-81-153-163-176-106-124-62-86-95-130-185-179-166-194-113-103-89-127-165-187-146-97-141-91-61-36"
9,49421,100,21240,70661,"8-82-21-177-5-45-142-78-175-36-61-91-141-77-97-146-187-165-127-89-103-137-114-113-194-166-172-179-185-22-99-130-95-86-183-140-152-170-34-55-18-62-124-106-176-163-153-81-41-111-144-0-35-109-29-160-33-11-134-74-118-121-51-90-131-151-54-31-193-117-198-156-1-16-27-38-135-63-40-107-122-133-10-115-147-6-188-169-132-13-70-3-15-145-195-168-139-182-138-104"
10,47424,100,21202,68626,"9-148-47-94-60-20-59-28-149-4-140-183-152-170-34-55-18-62-128-124-106-143-35-109-0-29-160-33-11-134-74-118-121-51-90-131-54-31-193-117-1-38-135-63-122-133-10-115-147-6-188-169-132-13-70-3-15-145-195-168-139-182-138-104-8-111-82-21-177-5-45-142-78-175-36-61-91-141-77-81-153-187-163-89-127-137-114-103-26-176-113-194-166-95-86-185-179-22-99-130"
11,52883,100,19298,72181,"10-115-147-192-6-188-169-132-161-70-3-15-145-13-195-168-43-11-29-109-35-0-111-81-153-163-176-106-124-86-95-130-185-179-166-194-113-103-89-127-165-187-146-77-141-91-61-36-175-78-142-45-5-177-21-82-8-104-144-160-33-138-182-139-134-85-74-118-98-51-116-121-112-19-151-54-73-164-31-193-117-198-156-1-16-27-38-131-125-191-90-135-102-63-100-40-107-72-122-133"
12,51749,100,18657,70406,"11-182-138-33-160-144-56-104-8-82-87-21-177-5-45-142-78-175-36-61-91-141-77-97-146-187-165-127-89-103-137-114-113-194-166-52-172-179-185-22-99-130-95-86-183-140-199-9-148-47-66-94-60-20-59-28-149-4-152-170-34-55-18-62-128-124-143-159-106-64-176-180-163-186-153-81-50-111-0-35-109-29-69-189-155-145-15-3-70-161-188-6-169-132-13-195-168-43-134-139"
13,51898,100,18680,70578,"12-111-50-81-153-186-163-180-176-64-106-159-143-124-128-62-18-55-34-170-152-4-149-28-59-20-60-94-66-47-148-9-199-140-183-86-95-130-99-22-185-179-172-166-194-113-114-137-103-89-127-165-187-146-97-77-141-91-61-36-175-78-142-45-5-177-21-87-82-8-104-56-144-160-33-138-182-11-139-134-43-168-195-13-132-169-6-188-161-70-3-15-145-155-189-69-29-109-35-0"
14,49084,100,20332,69416,"13-70-3-15-145-195-168-29-109-35-0-111-81-153-163-176-106-124-62-18-55-34-170-152-140-183-86-95-130-99-22-185-179-166-194-113-103-89-127-165-187-146-97-77-141-91-61-36-175-78-142-45-5-177-21-82-8-104-144-160-33-138-182-11-139-43-134-74-118-121-51-191-90-131-151-54-31-193-117-198-156-1-16-27-38-135-63-100-40-107-72-122-133-10-115-147-6-188-169-132"
15,52001,100,20501,72502,"14-81-153-163-180-176-64-106-143-124-128-62-18-55-34-170-152-140-183-86-95-130-99-22-185-179-172-166-194-113-114-137-103-89-127-165-187-146-97-141-77-82-21-8-104-138-182-139-168-195-145-15-3-70-13-132-169-188-6-192-147-115-10-133-122-72-107-40-100-63-135-38-27-16-1-156-198-117-193-31-73-54-151-19-131-90-191-51-121-118-74-134-11-33-160-29-0-109-35-111"
16,50083,100,17572,67655,"15-145-195-168-126-13-132-169-6-188-161-70-3-155-184-170-152-140-183-95-130-22-99-9-199-4-149-28-59-20-60-148-47-94-66-57-172-52-179-185-86-166-194-113-176-180-26-103-114-137-127-89-163-165-187-146-153-81-77-97-141-91-79-61-36-175-78-142-45-5-177-21-87-82-111-144-56-8-104-138-182-139-11-49-33-160-29-0-109-35-143-159-106-124-128-62-18-55-34-189"
17,53956,100,19040,72996,"16-27-38-92-102-63-96-32-135-122-133-10-178-115-147-71-191-90-51-125-131-121-112-19-151-54-73-164-31-136-45-5-177-21-104-138-182-139-168-195-145-15-3-70-161-13-132-169-188-6-134-11-49-33-160-29-109-35-0-144-111-8-82-58-77-81-153-163-176-86-95-130-185-179-166-194-113-103-89-127-165-187-146-97-141-91-61-36-142-78-175-162-80-190-193-117-198-156-24-1"
18,52706,100,19106,71812,"17-107-40-100-63-102-135-122-90-191-125-131-38-27-16-1-156-198-117-193-31-164-73-54-151-19-112-121-116-51-98-118-74-85-134-139-182-138-33-160-144-104-8-82-21-177-5-45-142-78-175-36-61-91-141-77-146-187-165-127-89-103-113-194-166-179-185-130-95-86-124-106-176-163-153-81-111-0-35-109-29-11-43-168-195-13-145-15-3-70-161-132-169-188-6-192-147-178-10-133"
19,51009,100,17976,68985,"18-55-34-83-128-86-176-180-113-194-166-52-172-179-185-22-99-130-95-183-140-199-9-148-47-66-94-60-20-59-28-149-4-152-170-184-155-189-3-70-15-145-13-132-169-188-6-126-195-168-43-139-11-182-138-33-160-144-56-104-8-82-87-21-177-5-45-142-78-175-36-61-79-91-141-77-97-146-187-165-137-114-127-89-103-163-186-153-81-50-111-109-29-0-35-143-159-106-124-62"
20,54018,100,19102,73120,"19-112-121-131-125-51-90-191-71-147-115-178-10-133-122-135-32-96-63-102-92-38-27-16-1-24-156-198-117-193-80-190-162-175-78-142-36-61-91-141-97-146-187-165-127-89-103-113-194-166-179-185-130-95-86-176-163-153-81-77-58-82-8-111-144-0-35-109-29-160-33-49-11-134-6-188-169-132-13-161-70-3-15-145-195-168-139-182-138-104-21-177-5-45-136-31-164-73-54-151"
21,47199,100,21075,68274,"20-60-94-66-47-148-99-22-179-185-86-95-130-166-194-113-176-26-103-114-137-127-89-163-187-153-81-77-141-91-61-36-175-78-142-45-5-177-21-82-111-8-104-138-182-139-168-195-145-15-3-70-13-132-169-188-6-147-115-10-133-122-63-135-38-1-117-193-31-54-131-90-51-121-118-74-134-11-33-160-29-0-109-35-143-106-124-128-62-18-55-34-170-152-183-140-4-149-28-59"
22,51930,100,19324,71254,"21-87-82-111-8-104-56-144-33-160-0-35-109-29-69-189-155-145-15-3-70-161-188-6-169-132-13-195-168-43-134-139-11-138-182-25-177-5-45-142-78-175-36-61-91-141-97-146-187-165-127-89-103-137-114-113-194-166-172-179-185-22-99-130-95-86-183-140-199-9-148-47-66-94-60-20-59-28-149-4-152-170-34-55-18-62-128-124-143-159-106-64-176-180-163-186-153-81-77-58"
23,48156,100,20514,68670,"22-99-130-95-183-140-152-170-34-55-18-62-128-124-106-143-35-109-0-29-160-33-11-134-74-118-121-51-90-131-1-38-135-63-122-133-10-115-147-6-188-169-132-13-70-3-15-145-195-168-139-182-138-104-8-111-82-21-177-5-45-142-78-175-36-61-91-141-77-81-153-187-163-89-127-137-114-103-26-176-113-194-166-86-185-179-172-57-66-94-47-148-60-20-59-28-149-4-199-9"
24,47660,100,21074,68734,"23-20-59-28-149-4-140-183-152-170-34-55-18-62-128-124-106-143-35-109-0-29-160-33-11-134-74-118-121-51-90-131-54-31-117-1-38-135-63-122-133-10-115-147-6-188-169-132-13-70-3-15-145-195-168-139-182-138-104-8-111-82-21-177-5-45-142-78-175-36-61-91-141-77-81-153-187-163-89-127-137-114-103-26-176-113-194-166-130-95-86-185-179-22-99-148-47-66-94-60"
25,52667,100,18391,71058,"24-156-198-117-193-31-164-73-54-151-19-112-121-116-158-25-182-138-33-160-144-104-8-82-21-177-5-45-142-78-175-36-61-91-141-77-146-187-165-127-89-103-113-194-166-179-185-130-95-86-62-124-106-176-163-153-81-111-0-35-109-29-11-139-43-168-195-145-15-3-70-13-132-169-188-6-134-74-118-98-51-125-90-191-71-147-115-178-10-133-122-135-32-96-63-92-38-27-16-1"
26,53794,100,20314,74108,"25-5-45-142-78-175-7-36-61-91-141-97-146-187-165-127-89-103-113-194-166-179-185-130-95-86-124-106-176-163-153-81-77-58-82-8-111-144-0-35-109-29-160-33-49-11-134-74-118-121-51-120-191-90-125-131-112-19-151-54-73-31-193-117-198-156-1-16-27-38-135-63-100-40-107-72-122-133-10-115-147-192-6-188-169-132-13-161-70-3-15-145-195-168-139-182-138-104-21-177"
27,51704,100,21475,73179,"26-103-114-137-127-89-163-165-187-146-97-141-77-82-21-8-104-138-182-139-168-195-145-15-3-70-13-132-169-188-6-147-115-10-133-122-63-135-38-1-117-31-131-90-51-121-118-74-134-11-33-160-29-0-109-35-111-81-153-129-180-176-64-106-159-143-124-128-62-18-55-34-170-152-4-149-28-59-20-60-94-66-47-148-9-199-140-183-86-95-130-99-22-185-179-172-52-166-194-113"
28,54018,100,19102,73120,"27-16-1-24-156-198-117-193-80-190-162-175-78-142-36-61-91-141-97-146-187-165-127-89-103-113-194-166-179-185-130-95-86-176-163-153-81-77-58-82-8-111-144-0-35-109-29-160-33-49-11-134-6-188-169-132-13-161-70-3-15-145-195-168-139-182-138-104-21-177-5-45-136-31-164-73-54-151-19-112-121-131-125-51-90-191-71-147-115-178-10-133-122-135-32-96-63-102-92-38"
29,47550,100,20891,68441,"28-149-4-140-183-152-170-34-55-18-62-128-124-106-143-35-109-0-29-160-33-11-134-74-118-121-51-90-131-31-117-1-38-135-63-122-133-10-115-147-6-188-169-132-13-70-3-15-145-195-168-139-182-138-104-8-111-82-21-177-5-45-142-78-175-36-61-91-141-77-81-153-187-163-89-127-137-114-103-26-176-113-194-166-22-99-130-95-86-185-179-172-57-66-94-47-148-60-20-59"
30,51749,100,18657,70406,"29-109-35-0-111-50-81-153-186-163-180-176-64-106-159-143-124-128-62-18-55-34-170-152-4-149-28-59-20-60-94-66-47-148-9-199-140-183-86-95-130-99-22-185-179-172-52-166-194-113-114-137-103-89-127-165-187-146-97-77-141-91-61-36-175-78-142-45-5-177-21-87-82-8-104-56-144-160-33-138-182-11-139-134-43-168-195-13-132-169-6-188-161-70-3-15-145-155-189-69"
31,52898,100,20435,73333,"30-80-190-162-175-78-142-36-61-91-141-97-146-187-165-127-89-103-113-194-166-179-185-130-95-86-62-124-106-176-163-153-81-77-58-82-8-111-144-0-35-109-29-160-33-49-11-134-74-118-121-51-120-191-90-125-131-135-102-63-100-40-107-72-122-133-10-115-147-192-6-188-169-132-13-161-70-3-15-145-195-168-139-182-138-104-21-177-5-45-136-193-31-164-73-54-117-198-1-156"
32,51743,100,20490,72233,"31-164-73-54-117-198-193-80-190-162-175-78-142-36-61-91-141-97-146-187-165-127-89-103-113-194-166-179-185-130-95-86-183-55-18-62-124-106-176-163-153-81-77-58-82-8-111-144-0-35-109-29-160-33-49-11-134-74-118-121-51-120-191-90-125-131-135-102-63-100-40-107-72-122-133-10-115-147-192-6-188-169-132-13-161-70-3-15-145-195-168-139-182-138-104-21-177-5-45-136"
33,53300,100,19027,72327,"32-102-63-100-40-107-72-133-10-115-147-192-6-188-169-132-161-70-3-15-145-13-195-168-43-11-29-109-35-0-111-81-153-163-176-106-86-95-130-185-179-166-194-113-103-89-127-165-187-146-77-141-91-61-36-175-78-142-45-5-177-21-82-8-104-144-160-33-138-182-139-134-85-74-118-98-51-116-121-112-19-151-54-73-164-31-193-117-198-156-1-16-27-38-131-125-191-90-122-135"
34,51749,100,18657,70406,"33-138-182-11-139-134-43-168-195-13-132-169-6-188-161-70-3-15-145-155-189-69-29-109-35-0-111-50-81-153-186-163-180-176-64-106-159-143-124-128-62-18-55-34-170-152-4-149-28-59-20-60-94-66-47-148-9-199-140-183-86-95-130-99-22-185-179-172-52-166-194-113-114-137-103-89-127-165-187-146-97-77-141-91-61-36-175-78-142-45-5-177-21-87-82-8-104-56-144-160"
35,51009,100,17976,68985,"34-83-128-86-176-180-113-194-166-52-172-179-185-22-99-130-95-183-140-199-9-148-47-66-94-60-20-59-28-149-4-152-170-184-155-189-3-70-15-145-13-132-169-188-6-126-195-168-43-139-11-182-138-33-160-144-56-104-8-82-87-21-177-5-45-142-78-175-36-61-79-91-141-77-97-146-187-165-137-114-127-89-103-163-186-153-81-50-111-109-29-0-35-143-159-106-124-62-18-55"
36,51749,100,18657,70406,"35-109-29-69-189-155-145-15-3-70-161-188-6-169-132-13-195-168-43-134-139-11-182-138-33-160-144-56-104-8-82-87-21-177-5-45-142-78-175-36-61-91-141-77-97-146-187-165-127-89-103-137-114-113-194-166-52-172-179-185-22-99-130-95-86-183-140-199-9-148-47-66-94-60-20-59-28-149-4-152-170-34-55-18-62-128-124-143-159-106-64-176-180-163-186-153-81-50-111-0"
37,52598,100,20266,72864,"36-141-97-146-187-165-127-89-103-113-194-166-179-185-130-95-86-18-62-124-106-176-163-153-81-77-58-82-8-111-144-0-35-109-29-160-33-49-11-134-74-118-121-51-120-191-90-125-131-112-19-151-54-73-31-193-117-198-156-1-16-27-38-135-63-100-40-107-72-122-133-10-115-147-192-6-188-169-132-13-161-70-3-15-145-195-168-139-182-138-104-21-177-5-45-142-78-175-91-61"
38,49684,100,21125,70809,"37-35-109-29-0-160-33-11-134-74-118-121-51-90-131-151-54-31-193-117-198-156-1-16-27-38-135-63-40-107-72-122-133-10-115-147-6-188-169-132-13-70-3-15-145-195-168-139-182-138-104-8-82-21-177-5-45-142-78-175-36-61-91-141-77-97-146-187-165-127-89-103-137-114-113-194-166-172-179-185-22-99-130-95-86-183-140-152-170-34-55-18-62-124-106-176-163-153-81-111"
39,53956,100,19040,72996,"38-92-102-63-96-32-135-122-133-10-178-115-147-71-191-90-51-125-131-121-112-19-151-54-73-164-31-136-45-5-177-21-104-138-182-139-168-195-145-15-3-70-161-13-132-169-188-6-134-11-49-33-160-29-109-35-0-144-111-8-82-58-77-81-153-163-176-86-95-130-185-179-166-194-113-103-89-127-165-187-146-97-141-91-61-36-142-78-175-162-80-190-193-117-198-156-24-1-16-27"
40,51917,100,18829,70746,"39-0-35-109-29-69-189-155-145-15-3-70-161-188-6-169-132-13-195-168-43-134-139-11-182-138-104-56-8-82-87-21-177-5-45-142-78-175-36-61-91-141-77-97-146-187-165-127-89-103-137-114-113-194-166-172-179-185-22-99-130-95-86-183-140-199-9-148-47-66-94-60-20-59-28-149-4-152-170-34-55-18-62-128-124-143-159-106-64-176-180-163-186-153-81-41-111-144-33-160"
41,52654,100,19069,71723,"40-100-63-102-135-122-90-191-125-131-38-27-16-1-156-198-117-193-31-164-73-54-151-19-112-121-116-51-98-118-74-85-134-139-182-138-33-160-144-104-8-82-21-177-5-45-142-78-175-36-61-91-141-77-146-187-165-127-89-103-113-194-166-179-185-130-95-86-124-106-176-163-153-81-111-0-35-109-29-11-43-168-195-13-145-15-3-70-161-132-169-188-6-192-147-115-10-133-72-107"
42,49401,100,21008,70409,"41-81-153-163-176-106-124-62-18-55-34-170-152-140-183-86-95-130-99-22-185-179-172-166-194-113-114-137-103-89-127-165-187-146-97-77-141-91-61-36-175-78-142-45-5-177-21-82-8-104-138-182-139-168-195-145-15-3-70-13-132-169-188-6-147-115-10-133-122-72-107-40-63-135-38-27-16-1-156-198-117-193-31-54-151-131-90-51-121-118-74-134-11-33-160-29-0-109-35-111"
43,53549,100,20697,74246,"42-108-80-190-162-175-78-142-36-61-91-141-97-146-187-165-127-89-103-113-194-166-179-185-130-95-86-124-106-176-163-153-81-77-58-82-8-111-144-0-35-109-29-160-33-49-11-134-74-118-121-51-120-191-90-125-131-135-102-63-100-40-107-72-122-133-10-115-147-192-6-188-169-132-13-161-70-3-15-145-195-168-139-182-138-104-21-177-5-45-136-73-164-193-31-54-117-198-1-156"
44,51003,100,20914,71917,"43-134-74-118-139-11-29-109-35-0-111-81-153-163-176-106-124-62-18-55-152-183-86-95-130-185-179-166-194-113-103-89-127-165-187-146-77-141-91-61-36-175-78-142-45-5-177-21-82-8-104-144-160-33-138-182-25-158-121-51-191-90-131-112-19-151-54-73-31-193-117-198-156-1-16-27-38-135-63-100-40-107-72-122-133-10-115-147-192-6-188-169-132-13-70-3-15-145-195-168"
45,53554,100,18861,72415,"44-122-72-17-107-40-100-63-102-135-38-27-16-1-156-198-117-193-31-164-73-54-151-19-112-131-121-116-158-25-182-138-33-160-144-104-8-82-21-177-5-45-142-78-175-36-61-91-141-77-146-187-165-127-89-103-113-194-166-179-185-95-86-176-163-153-81-111-0-35-109-29-11-139-43-168-195-145-15-3-70-13-132-169-188-6-134-74-118-98-51-125-90-191-71-147-115-178-10-133"
46,52253,100,19921,72174,"45-5-177-21-104-138-182-139-168-195-145-15-3-70-161-13-132-169-188-6-192-147-115-10-133-122-72-107-40-100-63-135-38-27-16-1-156-198-117-193-31-73-54-151-19-112-131-125-90-191-120-51-121-118-74-134-11-49-33-160-29-109-35-0-144-111-8-82-58-77-81-153-163-176-106-124-62-18-86-95-130-185-179-166-194-113-103-89-127-165-187-146-97-141-91-61-36-78-175-142"
47,52098,100,19917,72015,"46-80-190-193-198-117-54-31-164-73-136-45-5-177-21-104-138-182-139-168-195-145-15-3-70-161-13-132-169-188-6-192-147-115-10-133-122-72-107-40-100-63-102-135-131-125-90-191-120-51-121-118-74-134-11-49-33-160-29-109-35-0-144-111-8-82-58-77-81-153-163-176-106-124-62-18-55-86-95-130-185-179-166-194-113-103-89-127-165-187-146-97-141-91-61-36-142-78-175-162"
48,47922,100,21263,69185,"47-60-20-148-59-28-149-4-140-183-152-170-34-55-18-62-128-124-106-143-35-109-0-29-160-33-11-134-74-118-121-51-90-131-31-117-1-38-135-63-122-133-10-115-147-6-188-169-132-13-70-3-15-145-195-168-139-182-138-104-8-111-82-21-177-5-45-142-78-175-36-61-91-141-77-81-153-187-163-89-127-137-114-103-26-176-113-194-166-22-99-130-95-86-185-179-172-57-66-94"
49,49042,100,20992,70034,"48-194-113-176-26-103-114-137-127-89-163-187-153-81-77-141-91-61-36-175-78-142-45-5-177-21-82-111-8-104-138-182-139-168-195-145-15-3-70-13-132-169-188-6-147-115-10-133-122-63-135-1-131-90-51-121-118-74-134-11-33-160-29-0-109-35-143-106-124-128-62-18-55-34-170-152-140-183-130-95-86-185-22-99-9-199-4-149-28-59-20-60-148-47-94-66-57-172-179-166"
50,49238,100,21139,70377,"49-29-109-35-0-111-81-153-163-176-106-124-62-18-55-34-170-152-140-183-86-95-130-99-22-185-179-172-166-194-113-114-137-103-89-127-165-187-146-97-77-141-91-61-36-175-78-142-45-5-177-21-82-8-104-144-160-33-138-182-139-168-195-145-15-3-70-13-132-169-188-6-147-115-10-133-122-107-40-63-135-38-27-16-1-156-198-117-193-31-54-151-131-90-51-121-118-74-134-11"
51,52048,100,20554,72602,"50-81-153-163-180-176-64-106-143-124-128-62-18-55-34-170-152-140-183-86-95-130-99-22-185-179-172-166-194-113-114-137-103-89-127-165-187-146-97-141-77-82-21-8-104-138-182-139-168-195-145-15-3-70-13-132-169-188-6-192-147-115-10-133-122-72-107-40-100-63-135-38-27-16-1-156-198-117-193-31-73-54-151-19-131-90-191-51-121-118-74-134-11-33-160-29-0-109-35-111"
52,51328,100,19765,71093,"51-98-118-74-134-147-6-188-169-132-13-70-3-15-145-195-168-43-139-11-29-109-35-0-111-81-153-163-176-106-124-62-18-86-95-130-185-179-166-194-113-103-89-127-165-187-146-77-141-91-61-36-175-78-142-45-5-177-21-82-8-104-144-160-33-138-182-25-158-116-121-131-112-19-151-54-73-164-31-193-117-198-156-1-16-27-38-135-102-63-100-40-107-72-10-133-122-90-191-125"
53,48343,100,20562,68905,"52-166-194-113-176-26-103-114-137-127-89-163-187-153-81-77-141-91-61-36-175-78-142-45-5-177-21-82-111-8-104-138-182-139-168-195-145-15-3-70-13-132-169-188-6-147-115-10-133-122-63-135-38-1-131-90-51-121-118-74-134-11-33-160-29-0-109-35-143-106-124-128-62-18-55-34-170-152-140-183-130-95-86-185-22-99-9-199-4-149-28-59-20-60-148-47-94-66-179-172"
54,48309,100,20472,68781,"53-140-183-95-130-99-9-199-4-149-28-59-20-60-148-47-94-66-57-172-179-185-86-166-194-113-176-26-103-114-137-127-89-163-187-153-81-77-141-91-61-36-175-78-142-45-5-177-21-82-111-8-104-138-182-139-168-195-145-15-3-70-13-132-169-188-6-147-115-10-133-122-63-135-38-1-131-90-51-121-118-74-134-11-33-160-29-0-109-35-143-106-124-128-62-18-55-34-170-152"
55,51743,100,20490,72233,"54-117-198-193-80-190-162-175-78-142-36-61-91-141-97-146-187-165-127-89-103-113-194-166-179-185-130-95-86-183-55-18-62-124-106-176-163-153-81-77-58-82-8-111-144-0-35-109-29-160-33-49-11-134-74-118-121-51-120-191-90-125-131-135-102-63-100-40-107-72-122-133-10-115-147-192-6-188-169-132-13-161-70-3-15-145-195-168-139-182-138-104-21-177-5-45-136-31-164-73"
56,51009,100,17976,68985,"55-34-83-128-86-176-180-113-194-166-52-172-179-185-22-99-130-95-183-140-199-9-148-47-66-94-60-20-59-28-149-4-152-170-184-155-189-3-70-15-145-13-132-169-188-6-126-195-168-43-139-11-182-138-33-160-144-56-104-8-82-87-21-177-5-45-142-78-175-36-61-79-91-141-77-97-146-187-165-137-114-127-89-103-163-186-153-81-50-111-109-29-0-35-143-159-106-124-62-18"
57,55700,100,18552,74252,"56-144-111-0-35-109-29-160-33-49-11-43-134-85-74-118-98-121-51-120-71-191-90-125-131-112-19-151-54-73-164-31-193-117-198-156-1-16-27-38-135-96-63-100-40-107-72-122-133-10-178-115-147-192-6-188-169-132-13-161-70-3-15-145-195-168-139-182-138-104-25-177-5-45-142-78-175-36-61-91-141-97-146-187-165-127-89-103-113-194-166-176-163-153-81-77-58-21-82-8"
58,47550,100,20891,68441,"57-172-179-185-86-95-130-99-22-166-194-113-176-26-103-114-137-127-89-163-187-153-81-77-141-91-61-36-175-78-142-45-5-177-21-82-111-8-104-138-182-139-168-195-145-15-3-70-13-132-169-188-6-147-115-10-133-122-63-135-38-1-117-31-131-90-51-121-118-74-134-11-33-160-29-0-109-35-143-106-124-128-62-18-55-34-170-152-183-140-4-149-28-59-20-60-148-47-94-66"
59,52261,100,19929,72190,"58-82-8-111-144-0-35-109-29-160-33-49-11-134-74-118-121-51-120-191-90-125-131-112-19-151-54-73-31-193-117-198-156-1-16-27-38-135-63-100-40-107-72-122-133-10-115-147-192-6-188-169-132-13-161-70-3-15-145-195-168-139-182-138-104-21-177-5-45-142-78-175-36-61-91-141-97-146-187-165-127-89-103-113-194-166-179-185-130-95-86-18-62-124-106-176-163-153-81-77"
60,47550,100,20891,68441,"59-28-149-4-140-183-152-170-34-55-18-62-128-124-106-143-35-109-0-29-160-33-11-134-74-118-121-51-90-131-31-117-1-38-135-63-122-133-10-115-147-6-188-169-132-13-70-3-15-145-195-168-139-182-138-104-8-111-82-21-177-5-45-142-78-175-36-61-91-141-77-81-153-187-163-89-127-137-114-103-26-176-113-194-166-22-99-130-95-86-185-179-172-57-66-94-47-148-60-20"
61,47199,100,21075,68274,"60-94-66-47-148-99-22-179-185-86-95-130-166-194-113-176-26-103-114-137-127-89-163-187-153-81-77-141-91-61-36-175-78-142-45-5-177-21-82-111-8-104-138-182-139-168-195-145-15-3-70-13-132-169-188-6-147-115-10-133-122-63-135-38-1-117-193-31-54-131-90-51-121-118-74-134-11-33-160-29-0-109-35-143-106-124-128-62-18-55-34-170-152-183-140-4-149-28-59-20"
62,52598,100,20266,72864,"61-91-175-78-142-45-5-177-21-104-138-182-139-168-195-145-15-3-70-161-13-132-169-188-6-192-147-115-10-133-122-72-107-40-100-63-135-38-27-16-1-156-198-117-193-31-73-54-151-19-112-131-125-90-191-120-51-121-118-74-134-11-49-33-160-29-109-35-0-144-111-8-82-58-77-81-153-163-176-106-124-62-18-86-95-130-185-179-166-194-113-103-89-127-165-187-146-97-141-36"
63,51009,100,17976,68985,"62-124-106-159-143-35-0-29-109-111-50-81-153-186-163-103-89-127-114-137-165-187-146-97-77-141-91-79-61-36-175-78-142-45-5-177-21-87-82-8-104-56-144-160-33-138-182-11-139-43-168-195-126-6-188-169-132-13-145-15-70-3-189-155-184-170-152-4-149-28-59-20-60-94-66-47-148-9-199-140-183-95-130-99-22-185-179-172-52-166-194-113-180-176-86-128-83-34-55-18"
64,52654,100,19069,71723,"63-100-40-107-72-133-10-115-147-192-6-188-169-132-161-70-3-15-145-13-195-168-43-11-29-109-35-0-111-81-153-163-176-106-124-86-95-130-185-179-166-194-113-103-89-127-165-187-146-77-141-91-61-36-175-78-142-45-5-177-21-82-8-104-144-160-33-138-182-139-134-85-74-118-98-51-116-121-112-19-151-54-73-164-31-193-117-198-156-1-16-27-38-131-125-191-90-122-135-102"
65,51567,100,21182,72749,"64-86-95-128-106-159-143-124-62-18-55-34-170-152-174-183-140-199-4-149-28-59-20-60-148-47-94-66-22-130-99-185-179-172-52-166-194-113-26-103-114-137-127-89-163-165-187-146-97-141-77-82-21-8-104-138-182-139-168-195-145-15-3-70-13-132-169-188-6-147-115-10-133-122-63-135-38-1-117-31-131-90-51-121-118-74-134-11-33-160-29-0-109-35-111-81-153-129-180-176"
66,50172,100,17520,67692,"65-188-6-169-132-13-126-168-195-145-15-189-34-55-18-62-128-124-106-159-143-35-109-0-29-160-33-49-11-139-182-138-104-8-56-144-111-82-87-21-177-5-45-142-78-175-36-61-79-91-141-97-77-81-153-146-187-165-163-89-127-137-114-103-26-180-176-113-194-166-86-185-179-172-57-66-94-47-148-60-20-59-28-149-4-199-9-99-22-130-95-183-140-152-170-184-155-3-70-161"
67,47922,100,21263,69185,"66-57-172-179-185-86-95-130-99-22-166-194-113-176-26-103-114-137-127-89-163-187-153-81-77-141-91-61-36-175-78-142-45-5-177-21-82-111-8-104-138-182-139-168-195-145-15-3-70-13-132-169-188-6-147-115-10-133-122-63-135-38-1-117-31-131-90-51-121-118-74-134-11-33-160-29-0-109-35-143-106-124-128-62-18-55-34-170-152-183-140-4-149-28-59-148-20-60-47-94"
68,52693,100,19471,72164,"67-120-51-98-118-74-134-6-188-169-132-13-70-3-15-145-195-168-43-139-11-29-109-35-0-111-81-153-163-176-106-124-86-95-130-185-179-166-194-113-103-89-127-165-187-146-77-141-91-61-36-175-78-142-45-5-177-21-82-8-104-144-160-33-138-182-25-158-116-121-131-112-19-151-54-73-164-31-193-117-198-156-1-16-27-38-135-102-63-100-40-107-72-10-133-122-90-191-147-71"
69,54296,100,19699,73995,"68-111-37-35-109-0-29-160-33-49-11-134-74-118-121-51-120-191-90-125-131-112-19-151-54-73-31-193-117-198-156-1-16-27-38-135-63-100-40-107-72-122-133-10-115-147-192-6-188-169-132-13-161-70-3-15-145-195-168-139-182-138-104-8-171-177-5-45-142-78-175-36-61-91-141-97-146-187-165-127-89-103-113-194-166-179-185-130-95-86-124-106-176-163-153-81-77-58-21-82"
70,52475,100,18615,71090,"69-109-35-0-111-50-81-153-186-163-180-176-64-106-159-143-124-128-62-18-55-34-170-152-4-149-28-59-20-60-94-66-47-148-9-199-140-183-86-95-130-99-22-185-179-172-52-166-194-113-26-114-137-103-89-127-165-187-146-97-77-141-91-79-61-36-175-78-142-45-5-177-21-87-82-8-104-56-144-160-33-138-182-11-139-134-43-168-195-13-132-169-6-188-161-70-3-15-145-29"
71,50083,100,17572,67655,"70-161-188-6-169-132-13-126-168-195-145-15-189-34-55-18-62-128-124-106-159-143-35-109-0-29-160-33-49-11-139-182-138-104-8-56-144-111-82-87-21-177-5-45-142-78-175-36-61-79-91-141-97-77-81-153-146-187-165-163-89-127-137-114-103-26-180-176-113-194-166-86-185-179-52-172-57-66-94-47-148-60-20-59-28-149-4-199-9-99-22-130-95-183-140-152-170-184-155-3"
72,51754,100,19410,71164,"71-147-192-6-188-169-132-161-70-3-15-145-13-195-168-43-11-29-109-35-0-111-81-153-163-176-106-124-62-18-86-95-130-185-179-166-194-113-103-89-127-165-187-146-77-141-91-61-36-175-78-142-45-5-177-21-82-8-104-144-160-33-138-182-139-134-85-51-98-118-116-121-131-112-19-151-54-73-164-31-193-117-198-156-1-16-27-38-135-102-63-100-40-107-72-10-133-122-90-191"
73,52654,100,19069,71723,"72-107-40-100-63-102-135-122-90-191-125-131-38-27-16-1-156-198-117-193-31-164-73-54-151-19-112-121-116-51-98-118-74-85-134-139-182-138-33-160-144-104-8-82-21-177-5-45-142-78-175-36-61-91-141-77-146-187-165-127-89-103-113-194-166-179-185-130-95-86-124-106-176-163-153-81-111-0-35-109-29-11-43-168-195-13-145-15-3-70-161-132-169-188-6-192-147-115-10-133"
74,51743,100,20490,72233,"73-54-117-198-193-80-190-162-175-78-142-36-61-91-141-97-146-187-165-127-89-103-113-194-166-179-185-130-95-86-183-55-18-62-124-106-176-163-153-81-77-58-82-8-111-144-0-35-109-29-160-33-49-11-134-74-118-121-51-120-191-90-125-131-135-102-63-100-40-107-72-122-133-10-115-147-192-6-188-169-132-13-161-70-3-15-145-195-168-139-182-138-104-21-177-5-45-136-31-164"
75,52122,100,19792,71914,"74-98-51-125-191-90-122-133-10-72-107-40-100-63-102-135-38-27-16-1-24-156-198-117-193-31-164-73-54-151-19-112-131-121-116-158-25-182-138-33-160-144-104-8-82-21-177-5-45-142-78-175-36-61-91-141-77-146-187-165-127-89-103-113-194-166-179-185-130-95-86-62-124-106-176-163-153-81-111-0-35-109-29-11-139-43-168-195-145-15-3-70-13-132-169-188-6-147-134-118"
76,52053,100,21468,73521,"75-114-113-194-166-179-172-57-66-94-47-148-60-20-59-28-149-4-199-9-99-22-185-86-95-130-183-140-152-170-34-55-18-62-128-124-143-159-106-64-176-180-26-103-163-186-153-81-111-35-109-0-29-160-33-11-134-74-118-121-51-90-131-117-1-38-135-63-122-133-10-115-147-6-188-169-132-13-70-3-15-145-195-168-139-182-138-104-8-21-82-77-141-97-146-187-89-165-127-137"
77,51939,100,21231,73170,"76-166-52-172-179-185-22-99-130-95-183-140-199-9-148-47-66-94-60-20-59-28-149-4-53-152-170-34-55-18-62-124-143-159-106-128-86-194-176-180-113-26-103-163-186-153-81-111-35-109-0-29-160-33-11-134-74-118-121-51-90-131-117-1-38-135-63-122-133-10-115-147-6-188-169-132-13-70-3-15-145-195-168-139-182-138-104-8-21-82-77-141-97-146-187-89-165-127-137-114"
78,51753,100,21460,73213,"77-82-21-8-104-138-182-139-168-195-145-15-3-70-13-132-169-188-6-147-115-10-133-122-63-135-38-1-117-31-131-90-51-121-118-74-134-11-33-160-29-0-109-35-111-81-153-186-163-180-176-64-106-159-143-124-128-62-18-55-34-170-152-4-149-28-59-20-60-94-66-47-148-9-199-140-183-86-95-130-99-22-185-179-172-52-166-194-113-26-114-137-103-89-127-165-187-146-97-141"
79,52253,100,19921,72174,"78-36-61-91-141-97-146-187-165-127-89-103-113-194-166-179-185-130-95-86-18-62-124-106-176-163-153-81-77-58-82-8-111-144-0-35-109-29-160-33-49-11-134-74-118-121-51-120-191-90-125-131-112-19-151-54-73-31-193-117-198-156-1-16-27-38-135-63-100-40-107-72-122-133-10-115-147-192-6-188-169-132-13-161-70-3-15-145-195-168-139-182-138-104-21-177-5-45-142-175"
80,53183,100,20132,73315,"79-61-36-141-97-146-187-165-127-89-103-113-194-166-179-185-130-95-86-62-124-106-176-163-153-81-77-58-82-8-111-144-0-35-109-29-160-33-49-11-134-74-118-121-51-120-191-90-125-131-112-19-151-54-73-31-193-117-198-156-1-16-27-38-135-63-100-40-107-72-122-133-10-115-147-192-6-188-169-132-13-161-70-3-15-145-195-168-139-182-138-104-21-177-5-45-142-78-175-91"
81,51578,100,20325,71903,"80-162-175-78-142-36-61-91-141-97-146-187-165-127-89-103-113-194-166-179-185-130-95-86-183-55-18-62-124-106-176-163-153-81-77-58-82-8-111-144-0-35-109-29-160-33-49-11-134-74-118-121-51-120-191-90-125-131-135-102-63-100-40-107-72-122-133-10-115-147-192-6-188-169-132-13-161-70-3-15-145-195-168-139-182-138-104-21-177-5-45-136-73-164-31-54-117-198-193-190"
82,51753,100,21460,73213,"81-153-186-163-180-176-64-106-159-143-124-128-62-18-55-34-170-152-4-149-28-59-20-60-94-66-47-148-9-199-140-183-86-95-130-99-22-185-179-172-52-166-194-113-26-114-137-103-89-127-165-187-146-97-141-77-82-21-8-104-138-182-139-168-195-145-15-3-70-13-132-169-188-6-147-115-10-133-122-63-135-38-1-117-31-131-90-51-121-118-74-134-11-33-160-29-0-109-35-111"
83,51930,100,19324,71254,"82-87-21-58-77-81-153-186-163-180-176-64-106-159-143-124-128-62-18-55-34-170-152-4-149-28-59-20-60-94-66-47-148-9-199-140-183-86-95-130-99-22-185-179-172-166-194-113-114-137-103-89-127-165-187-146-97-141-91-61-36-175-78-142-45-5-177-25-182-138-11-139-134-43-168-195-13-132-169-6-188-161-70-3-15-145-155-189-69-29-109-35-0-160-33-144-56-104-8-111"
84,48583,100,20796,69379,"83-170-152-140-183-95-130-99-9-199-4-149-28-59-20-60-148-47-94-66-57-172-179-185-86-166-194-113-176-26-103-114-137-127-89-163-187-153-81-77-141-91-61-36-175-78-142-45-5-177-21-82-111-8-104-138-182-139-168-195-145-15-3-70-13-132-169-188-6-147-115-10-133-122-63-135-38-1-131-90-51-121-118-74-134-11-33-160-29-0-109-35-143-106-124-128-62-18-34-55"
85,51891,100,18320,70211,"84-70-3-15-145-13-132-169-188-6-126-195-168-43-139-11-182-138-33-160-144-56-104-8-82-87-21-177-5-45-142-78-175-36-61-91-141-77-97-146-187-165-127-89-103-137-114-113-194-166-52-172-179-185-22-99-130-95-86-183-140-199-9-148-47-66-94-60-20-59-28-149-4-152-170-34-55-18-62-128-124-143-159-106-64-176-180-163-186-153-81-50-111-29-0-35-109-69-189-155"
86,49204,100,20264,69468,"85-74-118-121-51-191-90-131-151-54-31-193-117-198-156-1-16-27-38-135-63-100-40-107-72-122-133-10-115-147-6-188-169-132-70-3-15-145-13-195-168-29-109-35-0-111-81-153-163-176-106-124-62-18-55-34-170-152-140-183-86-95-130-99-185-179-166-194-113-103-89-127-165-187-146-97-77-141-91-61-36-175-78-142-45-5-177-21-82-8-104-144-160-33-138-182-11-139-43-134"
87,48135,100,21090,69225,"86-95-185-179-172-166-194-113-176-26-103-114-137-127-89-163-187-153-81-77-141-91-61-36-175-78-142-45-5-177-21-82-111-8-104-138-182-139-168-195-145-15-3-70-13-132-169-188-6-147-115-10-133-122-63-135-38-1-117-131-90-51-121-118-74-134-11-33-160-29-0-109-35-143-106-124-128-62-18-55-34-170-152-140-183-9-199-4-149-28-59-20-60-148-47-94-66-22-99-130"
88,51930,100,19324,71254,"87-82-111-8-104-56-144-33-160-0-35-109-29-69-189-155-145-15-3-70-161-188-6-169-132-13-195-168-43-134-139-11-138-182-25-177-5-45-142-78-175-36-61-91-141-97-146-187-165-127-89-103-137-114-113-194-166-172-179-185-22-99-130-95-86-183-140-199-9-148-47-66-94-60-20-59-28-149-4-152-170-34-55-18-62-128-124-143-159-106-64-176-180-163-186-153-81-77-58-21"
89,48568,100,20698,69266,"88-26-103-127-89-163-187-153-81-77-141-91-61-36-175-78-142-45-5-177-21-82-111-8-104-138-182-139-168-195-145-15-3-70-13-132-169-188-6-147-115-10-133-122-63-135-38-1-117-131-90-51-121-118-74-134-11-33-160-29-0-109-35-143-106-124-128-62-18-55-34-170-152-140-183-130-95-86-185-22-99-9-199-4-149-28-59-20-60-148-47-94-66-57-172-179-166-194-113-176"
90,51704,100,21475,73179,"89-163-165-187-146-97-141-77-82-21-8-104-138-182-139-168-195-145-15-3-70-13-132-169-188-6-147-115-10-133-122-63-135-38-1-117-31-131-90-51-121-118-74-134-11-33-160-29-0-109-35-111-81-153-129-180-176-64-106-159-143-124-128-62-18-55-34-170-152-4-149-28-59-20-60-94-66-47-148-9-199-140-183-86-95-130-99-22-185-179-172-52-166-194-113-26-103-114-137-127"
91,52137,100,19212,71349,"90-122-133-10-72-107-40-100-63-102-135-38-27-16-1-156-198-117-193-31-164-73-54-151-19-112-131-121-116-51-98-118-74-85-134-139-182-138-33-160-144-104-8-82-21-177-5-45-142-78-175-36-61-91-141-77-146-187-165-127-89-103-113-194-166-179-185-130-95-86-62-124-106-176-163-153-81-111-0-35-109-29-11-43-168-195-13-145-15-3-70-161-132-169-188-6-192-147-71-191"
92,52598,100,20266,72864,"91-61-36-141-97-146-187-165-127-89-103-113-194-166-179-185-130-95-86-18-62-124-106-176-163-153-81-77-58-82-8-111-144-0-35-109-29-160-33-49-11-134-74-118-121-51-120-191-90-125-131-112-19-151-54-73-31-193-117-198-156-1-16-27-38-135-63-100-40-107-72-122-133-10-115-147-192-6-188-169-132-13-161-70-3-15-145-195-168-139-182-138-104-21-177-5-45-142-78-175"
93,53487,100,19117,72604,"92-102-135-122-90-191-125-131-38-27-16-1-156-198-117-193-31-164-73-54-151-19-112-121-116-51-98-118-74-85-134-139-182-138-33-160-144-104-8-82-21-177-5-45-142-78-175-36-61-91-141-77-146-187-165-127-89-103-113-194-166-179-185-130-95-86-106-176-163-153-81-111-0-35-109-29-11-43-168-195-13-145-15-3-70-161-132-169-188-6-192-147-115-10-133-72-107-40-100-63"
94,53018,100,21154,74172,"93-48-166-52-172-179-185-22-99-130-95-183-140-199-9-148-47-66-94-60-20-59-28-149-4-53-152-170-34-55-18-62-124-143-159-106-128-86-194-176-180-113-26-103-163-186-153-81-111-35-109-0-29-160-33-11-134-74-118-121-51-90-131-1-135-63-122-133-10-115-147-6-188-169-132-13-70-3-15-145-195-168-139-182-138-104-8-21-82-77-141-97-146-187-89-165-127-114-137-75"
95,47922,100,21263,69185,"94-66-57-172-179-185-86-95-130-99-22-166-194-113-176-26-103-114-137-127-89-163-187-153-81-77-141-91-61-36-175-78-142-45-5-177-21-82-111-8-104-138-182-139-168-195-145-15-3-70-13-132-169-188-6-147-115-10-133-122-63-135-38-1-117-31-131-90-51-121-118-74-134-11-33-160-29-0-109-35-143-106-124-128-62-18-55-34-170-152-183-140-4-149-28-59-148-20-60-47"
96,48135,100,21090,69225,"95-86-130-99-22-66-94-47-148-60-20-59-28-149-4-199-9-183-140-152-170-34-55-18-62-128-124-106-143-35-109-0-29-160-33-11-134-74-118-121-51-90-131-117-1-38-135-63-122-133-10-115-147-6-188-169-132-13-70-3-15-145-195-168-139-182-138-104-8-111-82-21-177-5-45-142-78-175-36-61-91-141-77-81-153-187-163-89-127-137-114-103-26-176-113-194-166-172-179-185"
97,52719,100,19040,71759,"96-135-122-90-191-125-131-38-27-16-1-156-198-117-193-31-164-73-54-151-19-112-121-116-51-98-118-74-85-134-139-182-138-33-160-144-104-8-82-21-177-5-45-142-78-175-36-61-91-141-77-146-187-165-127-89-103-113-194-166-179-185-130-95-86-124-106-176-163-153-81-111-0-35-109-29-11-43-168-195-13-145-15-3-70-161-132-169-188-6-192-147-115-10-133-72-107-40-100-63"
98,51753,100,21460,73213,"97-141-77-82-21-8-104-138-182-139-168-195-145-15-3-70-13-132-169-188-6-147-115-10-133-122-63-135-38-1-117-31-131-90-51-121-118-74-134-11-33-160-29-0-109-35-111-81-153-186-163-180-176-64-106-159-143-124-128-62-18-55-34-170-152-4-149-28-59-20-60-94-66-47-148-9-199-140-183-86-95-130-99-22-185-179-172-52-166-194-113-26-114-137-103-89-127-165-187-146"
99,51328,100,19765,71093,"98-118-74-134-147-6-188-169-132-13-70-3-15-145-195-168-43-139-11-29-109-35-0-111-81-153-163-176-106-124-62-18-86-95-130-185-179-166-194-113-103-89-127-165-187-146-77-141-91-61-36-175-78-142-45-5-177-21-82-8-104-144-160-33-138-182-25-158-116-121-131-112-19-151-54-73-164-31-193-117-198-156-1-16-27-38-135-102-63-100-40-107-72-10-133-122-90-191-125-51"
100,47995,100,20918,68913,"99-130-95-183-140-152-170-34-55-18-62-128-124-106-143-35-109-0-29-160-33-11-134-74-118-121-51-90-131-117-1-38-135-63-122-133-10-115-147-6-188-169-132-13-70-3-15-145-195-168-139-182-138-104-8-111-82-21-177-5-45-142-78-175-36-61-91-141-77-81-153-187-163-89-127-137-114-103-26-176-113-194-166-86-185-179-172-57-66-94-47-148-60-20-59-28-149-4-199-9"
