SolutionID,TotalCost,NumNodes,TotalDistance,ObjectiveFunction,Cycle
1,52598,100,20266,72864,"91-61-36-141-97-146-187-165-127-89-103-113-194-166-179-185-130-95-86-18-62-124-106-176-163-153-81-77-58-82-8-111-144-0-35-109-29-160-33-49-11-134-74-118-121-51-120-191-90-125-131-112-19-151-54-73-31-193-117-198-156-1-16-27-38-135-63-100-40-107-72-122-133-10-115-147-192-6-188-169-132-13-161-70-3-15-145-195-168-139-182-138-104-21-177-5-45-142-78-175"
2,50083,100,17572,67655,"15-145-195-168-126-13-132-169-6-188-161-70-3-155-184-170-152-140-183-95-130-22-99-9-199-4-149-28-59-20-60-148-47-94-66-57-172-52-179-185-86-166-194-113-176-180-26-103-114-137-127-89-163-165-187-146-153-81-77-97-141-91-79-61-36-175-78-142-45-5-177-21-87-82-111-144-56-8-104-138-182-139-11-49-33-160-29-0-109-35-143-159-106-124-128-62-18-55-34-189"
3,48156,100,20514,68670,"22-99-130-95-183-140-152-170-34-55-18-62-128-124-106-143-35-109-0-29-160-33-11-134-74-118-121-51-90-131-1-38-135-63-122-133-10-115-147-6-188-169-132-13-70-3-15-145-195-168-139-182-138-104-8-111-82-21-177-5-45-142-78-175-36-61-91-141-77-81-153-187-163-89-127-137-114-103-26-176-113-194-166-86-185-179-172-57-66-94-47-148-60-20-59-28-149-4-199-9"
4,51009,100,17976,68985,"34-83-128-86-176-180-113-194-166-52-172-179-185-22-99-130-95-183-140-199-9-148-47-66-94-60-20-59-28-149-4-152-170-184-155-189-3-70-15-145-13-132-169-188-6-126-195-168-43-139-11-182-138-33-160-144-56-104-8-82-87-21-177-5-45-142-78-175-36-61-79-91-141-77-97-146-187-165-137-114-127-89-103-163-186-153-81-50-111-109-29-0-35-143-159-106-124-62-18-55"
5,47660,100,21074,68734,"23-20-59-28-149-4-140-183-152-170-34-55-18-62-128-124-106-143-35-109-0-29-160-33-11-134-74-118-121-51-90-131-54-31-117-1-38-135-63-122-133-10-115-147-6-188-169-132-13-70-3-15-145-195-168-139-182-138-104-8-111-82-21-177-5-45-142-78-175-36-61-91-141-77-81-153-187-163-89-127-137-114-103-26-176-113-194-166-130-95-86-185-179-22-99-148-47-66-94-60"
6,49084,100,20332,69416,"13-70-3-15-145-195-168-29-109-35-0-111-81-153-163-176-106-124-62-18-55-34-170-152-140-183-86-95-130-99-22-185-179-166-194-113-103-89-127-165-187-146-97-77-141-91-61-36-175-78-142-45-5-177-21-82-8-104-144-160-33-138-182-11-139-43-134-74-118-121-51-191-90-131-151-54-31-193-117-198-156-1-16-27-38-135-63-100-40-107-72-122-133-10-115-147-6-188-169-132"
7,49254,100,20393,69647,"158-25-182-138-33-160-144-104-8-82-21-177-5-45-142-78-175-36-61-91-141-77-146-187-165-127-89-103-113-194-166-179-185-130-95-86-183-140-152-170-34-55-18-62-124-106-176-163-153-81-111-0-35-109-29-11-139-43-168-195-145-15-3-70-13-132-169-188-6-147-134-74-118-98-51-125-90-122-133-72-107-40-100-63-102-135-38-27-16-1-156-198-117-193-31-73-54-151-131-121"
8,48054,100,21600,69654,"124-128-62-34-55-18-109-29-0-35-160-33-11-134-74-118-121-51-90-131-54-31-193-117-156-1-38-135-63-122-133-10-115-147-6-188-169-132-13-70-3-15-145-195-168-139-182-138-104-144-111-8-82-21-177-5-45-142-78-175-36-61-91-141-77-81-153-187-163-89-127-137-114-103-26-113-176-194-166-172-179-185-99-130-66-94-47-148-60-20-59-28-149-4-140-183-95-86-143-106"
9,52253,100,19921,72174,"175-142-45-5-177-21-104-138-182-139-168-195-145-15-3-70-161-13-132-169-188-6-192-147-115-10-133-122-72-107-40-100-63-135-38-27-16-1-156-198-117-193-31-73-54-151-19-112-131-125-90-191-120-51-121-118-74-134-11-49-33-160-29-109-35-0-144-111-8-82-58-77-81-153-163-176-106-124-62-18-86-95-130-185-179-166-194-113-103-89-127-165-187-146-97-141-91-61-36-78"
10,50083,100,17572,67655,"15-145-195-168-126-13-132-169-6-188-161-70-3-155-184-170-152-140-183-95-130-22-99-9-199-4-149-28-59-20-60-148-47-94-66-57-172-52-179-185-86-166-194-113-176-180-26-103-114-137-127-89-163-165-187-146-153-81-77-97-141-91-79-61-36-175-78-142-45-5-177-21-87-82-111-144-56-8-104-138-182-139-11-49-33-160-29-0-109-35-143-159-106-124-128-62-18-55-34-189"
11,47995,100,20918,68913,"140-152-170-34-55-18-62-128-124-106-143-35-109-0-29-160-33-11-134-74-118-121-51-90-131-117-1-38-135-63-122-133-10-115-147-6-188-169-132-13-70-3-15-145-195-168-139-182-138-104-8-111-82-21-177-5-45-142-78-175-36-61-91-141-77-81-153-187-163-89-127-137-114-103-26-176-113-194-166-86-185-179-172-57-66-94-47-148-60-20-59-28-149-4-199-9-99-130-95-183"
12,50083,100,17572,67655,"3-155-184-170-152-140-183-95-130-22-99-9-199-4-149-28-59-20-60-148-47-94-66-57-172-52-179-185-86-166-194-113-176-180-26-103-114-137-127-89-163-165-187-146-153-81-77-97-141-91-79-61-36-175-78-142-45-5-177-21-87-82-111-144-56-8-104-138-182-139-11-49-33-160-29-0-109-35-143-159-106-124-128-62-18-55-34-189-15-145-195-168-126-13-132-169-6-188-161-70"
13,52883,100,19298,72181,"133-122-72-107-40-100-63-102-135-90-191-125-131-38-27-16-1-156-198-117-193-31-164-73-54-151-19-112-121-116-51-98-118-74-85-134-139-182-138-33-160-144-104-8-82-21-177-5-45-142-78-175-36-61-91-141-77-146-187-165-127-89-103-113-194-166-179-185-130-95-86-124-106-176-163-153-81-111-0-35-109-29-11-43-168-195-13-145-15-3-70-161-132-169-188-6-192-147-115-10"
14,51930,100,19324,71254,"82-87-21-58-77-81-153-186-163-180-176-64-106-159-143-124-128-62-18-55-34-170-152-4-149-28-59-20-60-94-66-47-148-9-199-140-183-86-95-130-99-22-185-179-172-166-194-113-114-137-103-89-127-165-187-146-97-141-91-61-36-175-78-142-45-5-177-25-182-138-11-139-134-43-168-195-13-132-169-6-188-161-70-3-15-145-155-189-69-29-109-35-0-160-33-144-56-104-8-111"
15,53956,100,19040,72996,"38-92-102-63-96-32-135-122-133-10-178-115-147-71-191-90-51-125-131-121-112-19-151-54-73-164-31-136-45-5-177-21-104-138-182-139-168-195-145-15-3-70-161-13-132-169-188-6-134-11-49-33-160-29-109-35-0-144-111-8-82-58-77-81-153-163-176-86-95-130-185-179-166-194-113-103-89-127-165-187-146-97-141-91-61-36-142-78-175-162-80-190-193-117-198-156-24-1-16-27"
16,51743,100,20490,72233,"164-73-54-117-198-193-80-190-162-175-78-142-36-61-91-141-97-146-187-165-127-89-103-113-194-166-179-185-130-95-86-183-55-18-62-124-106-176-163-153-81-77-58-82-8-111-144-0-35-109-29-160-33-49-11-134-74-118-121-51-120-191-90-125-131-135-102-63-100-40-107-72-122-133-10-115-147-192-6-188-169-132-13-161-70-3-15-145-195-168-139-182-138-104-21-177-5-45-136-31"
17,51753,100,21460,73213,"77-82-21-8-104-138-182-139-168-195-145-15-3-70-13-132-169-188-6-147-115-10-133-122-63-135-38-1-117-31-131-90-51-121-118-74-134-11-33-160-29-0-109-35-111-81-153-186-163-180-176-64-106-159-143-124-128-62-18-55-34-170-152-4-149-28-59-20-60-94-66-47-148-9-199-140-183-86-95-130-99-22-185-179-172-52-166-194-113-26-114-137-103-89-127-165-187-146-97-141"
18,55700,100,18552,74252,"56-144-111-0-35-109-29-160-33-49-11-43-134-85-74-118-98-121-51-120-71-191-90-125-131-112-19-151-54-73-164-31-193-117-198-156-1-16-27-38-135-96-63-100-40-107-72-122-133-10-178-115-147-192-6-188-169-132-13-161-70-3-15-145-195-168-139-182-138-104-25-177-5-45-142-78-175-36-61-91-141-97-146-187-165-127-89-103-113-194-166-176-163-153-81-77-58-21-82-8"
19,51743,100,20490,72233,"164-73-54-117-198-193-80-190-162-175-78-142-36-61-91-141-97-146-187-165-127-89-103-113-194-166-179-185-130-95-86-183-55-18-62-124-106-176-163-153-81-77-58-82-8-111-144-0-35-109-29-160-33-49-11-134-74-118-121-51-120-191-90-125-131-135-102-63-100-40-107-72-122-133-10-115-147-192-6-188-169-132-13-161-70-3-15-145-195-168-139-182-138-104-21-177-5-45-136-31"
20,47144,100,21152,68296,"199-183-140-95-130-99-22-179-185-86-166-194-113-176-26-103-114-137-127-89-163-187-153-81-77-141-91-61-36-175-78-142-45-5-177-21-82-111-8-104-138-182-139-168-195-145-15-3-70-13-132-169-188-6-147-115-10-133-122-63-135-38-1-117-193-31-54-131-90-51-121-118-74-134-11-33-160-29-0-109-35-143-106-124-128-62-18-55-34-170-152-4-149-28-20-60-94-66-47-148"
21,53018,100,21154,74172,"93-48-166-52-172-179-185-22-99-130-95-183-140-199-9-148-47-66-94-60-20-59-28-149-4-53-152-170-34-55-18-62-124-143-159-106-128-86-194-176-180-113-26-103-163-186-153-81-111-35-109-0-29-160-33-11-134-74-118-121-51-90-131-1-135-63-122-133-10-115-147-6-188-169-132-13-70-3-15-145-195-168-139-182-138-104-8-21-82-77-141-97-146-187-89-165-127-114-137-75"
22,52253,100,19921,72174,"142-45-5-177-21-104-138-182-139-168-195-145-15-3-70-161-13-132-169-188-6-192-147-115-10-133-122-72-107-40-100-63-135-38-27-16-1-156-198-117-193-31-73-54-151-19-112-131-125-90-191-120-51-121-118-74-134-11-49-33-160-29-109-35-0-144-111-8-82-58-77-81-153-163-176-106-124-62-18-86-95-130-185-179-166-194-113-103-89-127-165-187-146-97-141-91-61-36-78-175"
23,51853,100,18396,70249,"182-139-11-43-168-195-13-132-169-6-188-161-70-3-15-145-155-189-69-29-109-35-0-111-50-81-153-186-163-180-176-64-106-159-143-124-128-62-18-55-34-170-152-4-149-28-59-20-60-94-66-47-148-9-199-140-183-86-95-130-99-22-185-179-172-52-166-194-113-114-137-103-89-127-165-187-146-97-77-141-91-79-61-36-175-78-142-45-5-177-21-87-82-8-104-56-144-160-33-138"
24,53154,100,19973,73127,"123-5-45-142-78-175-36-61-91-141-97-146-187-165-127-89-103-113-194-166-179-185-130-95-86-62-124-106-176-163-153-81-77-58-82-8-111-144-0-35-109-29-160-33-49-11-134-74-118-121-51-120-191-90-125-131-112-19-151-54-73-31-193-117-198-156-1-16-27-38-135-63-100-40-107-72-122-133-10-115-147-192-6-188-169-132-13-161-70-3-15-145-195-168-139-182-138-104-21-177"
25,52253,100,19921,72174,"175-142-45-5-177-21-104-138-182-139-168-195-145-15-3-70-161-13-132-169-188-6-192-147-115-10-133-122-72-107-40-100-63-135-38-27-16-1-156-198-117-193-31-73-54-151-19-112-131-125-90-191-120-51-121-118-74-134-11-49-33-160-29-109-35-0-144-111-8-82-58-77-81-153-163-176-106-124-62-18-86-95-130-185-179-166-194-113-103-89-127-165-187-146-97-141-91-61-36-78"
26,51578,100,20325,71903,"190-193-198-117-54-31-164-73-136-45-5-177-21-104-138-182-139-168-195-145-15-3-70-161-13-132-169-188-6-192-147-115-10-133-122-72-107-40-100-63-102-135-131-125-90-191-120-51-121-118-74-134-11-49-33-160-29-109-35-0-144-111-8-82-58-77-81-153-163-176-106-124-62-18-55-183-86-95-130-185-179-166-194-113-103-89-127-165-187-146-97-141-91-61-36-142-78-175-162-80"
27,51237,100,21147,72384,"128-106-159-143-124-62-18-55-34-170-152-140-183-95-130-22-99-9-199-4-149-28-59-20-60-148-47-94-66-57-172-179-185-86-166-194-113-26-103-114-137-127-89-163-165-187-146-97-141-77-82-21-8-104-138-182-139-168-195-145-15-3-70-13-132-169-188-6-147-115-10-133-122-63-135-38-1-117-31-131-90-51-121-118-74-134-11-33-160-29-0-109-35-111-81-153-129-180-176-64"
28,47995,100,20918,68913,"152-170-34-55-18-62-128-124-106-143-35-109-0-29-160-33-11-134-74-118-121-51-90-131-117-1-38-135-63-122-133-10-115-147-6-188-169-132-13-70-3-15-145-195-168-139-182-138-104-8-111-82-21-177-5-45-142-78-175-36-61-91-141-77-81-153-187-163-89-127-137-114-103-26-176-113-194-166-86-185-179-172-57-66-94-47-148-60-20-59-28-149-4-199-9-99-130-95-183-140"
29,49238,100,21139,70377,"49-29-109-35-0-111-81-153-163-176-106-124-62-18-55-34-170-152-140-183-86-95-130-99-22-185-179-172-166-194-113-114-137-103-89-127-165-187-146-97-77-141-91-61-36-175-78-142-45-5-177-21-82-8-104-144-160-33-138-182-139-168-195-145-15-3-70-13-132-169-188-6-147-115-10-133-122-107-40-63-135-38-27-16-1-156-198-117-193-31-54-151-131-90-51-121-118-74-134-11"
30,51753,100,21460,73213,"97-141-77-82-21-8-104-138-182-139-168-195-145-15-3-70-13-132-169-188-6-147-115-10-133-122-63-135-38-1-117-31-131-90-51-121-118-74-134-11-33-160-29-0-109-35-111-81-153-186-163-180-176-64-106-159-143-124-128-62-18-55-34-170-152-4-149-28-59-20-60-94-66-47-148-9-199-140-183-86-95-130-99-22-185-179-172-52-166-194-113-26-114-137-103-89-127-165-187-146"
31,49421,100,21240,70661,"8-82-21-177-5-45-142-78-175-36-61-91-141-77-97-146-187-165-127-89-103-137-114-113-194-166-172-179-185-22-99-130-95-86-183-140-152-170-34-55-18-62-124-106-176-163-153-81-41-111-144-0-35-109-29-160-33-11-134-74-118-121-51-90-131-151-54-31-193-117-198-156-1-16-27-38-135-63-40-107-122-133-10-115-147-6-188-169-132-13-70-3-15-145-195-168-139-182-138-104"
32,47922,100,21263,69185,"47-60-20-148-59-28-149-4-140-183-152-170-34-55-18-62-128-124-106-143-35-109-0-29-160-33-11-134-74-118-121-51-90-131-31-117-1-38-135-63-122-133-10-115-147-6-188-169-132-13-70-3-15-145-195-168-139-182-138-104-8-111-82-21-177-5-45-142-78-175-36-61-91-141-77-81-153-187-163-89-127-137-114-103-26-176-113-194-166-22-99-130-95-86-185-179-172-57-66-94"
33,47550,100,20891,68441,"28-149-4-140-183-152-170-34-55-18-62-128-124-106-143-35-109-0-29-160-33-11-134-74-118-121-51-90-131-31-117-1-38-135-63-122-133-10-115-147-6-188-169-132-13-70-3-15-145-195-168-139-182-138-104-8-111-82-21-177-5-45-142-78-175-36-61-91-141-77-81-153-187-163-89-127-137-114-103-26-176-113-194-166-22-99-130-95-86-185-179-172-57-66-94-47-148-60-20-59"
34,48135,100,21090,69225,"185-95-86-130-99-22-66-94-47-148-60-20-59-28-149-4-199-9-183-140-152-170-34-55-18-62-128-124-106-143-35-109-0-29-160-33-11-134-74-118-121-51-90-131-117-1-38-135-63-122-133-10-115-147-6-188-169-132-13-70-3-15-145-195-168-139-182-138-104-8-111-82-21-177-5-45-142-78-175-36-61-91-141-77-81-153-187-163-89-127-137-114-103-26-176-113-194-166-172-179"
35,47922,100,21263,69185,"148-59-28-149-4-140-183-152-170-34-55-18-62-128-124-106-143-35-109-0-29-160-33-11-134-74-118-121-51-90-131-31-117-1-38-135-63-122-133-10-115-147-6-188-169-132-13-70-3-15-145-195-168-139-182-138-104-8-111-82-21-177-5-45-142-78-175-36-61-91-141-77-81-153-187-163-89-127-137-114-103-26-176-113-194-166-22-99-130-95-86-185-179-172-57-66-94-47-60-20"
36,51743,100,20490,72233,"31-164-73-54-117-198-193-80-190-162-175-78-142-36-61-91-141-97-146-187-165-127-89-103-113-194-166-179-185-130-95-86-183-55-18-62-124-106-176-163-153-81-77-58-82-8-111-144-0-35-109-29-160-33-49-11-134-74-118-121-51-120-191-90-125-131-135-102-63-100-40-107-72-122-133-10-115-147-192-6-188-169-132-13-161-70-3-15-145-195-168-139-182-138-104-21-177-5-45-136"
37,47995,100,20918,68913,"152-170-34-55-18-62-128-124-106-143-35-109-0-29-160-33-11-134-74-118-121-51-90-131-117-1-38-135-63-122-133-10-115-147-6-188-169-132-13-70-3-15-145-195-168-139-182-138-104-8-111-82-21-177-5-45-142-78-175-36-61-91-141-77-81-153-187-163-89-127-137-114-103-26-176-113-194-166-86-185-179-172-57-66-94-47-148-60-20-59-28-149-4-199-9-99-130-95-183-140"
38,52719,100,19040,71759,"96-135-122-90-191-125-131-38-27-16-1-156-198-117-193-31-164-73-54-151-19-112-121-116-51-98-118-74-85-134-139-182-138-33-160-144-104-8-82-21-177-5-45-142-78-175-36-61-91-141-77-146-187-165-127-89-103-113-194-166-179-185-130-95-86-124-106-176-163-153-81-111-0-35-109-29-11-43-168-195-13-145-15-3-70-161-132-169-188-6-192-147-115-10-133-72-107-40-100-63"
39,51328,100,19765,71093,"118-74-134-147-6-188-169-132-13-70-3-15-145-195-168-43-139-11-29-109-35-0-111-81-153-163-176-106-124-62-18-86-95-130-185-179-166-194-113-103-89-127-165-187-146-77-141-91-61-36-175-78-142-45-5-177-21-82-8-104-144-160-33-138-182-25-158-116-121-131-112-19-151-54-73-164-31-193-117-198-156-1-16-27-38-135-102-63-100-40-107-72-10-133-122-90-191-125-51-98"
40,48115,100,21070,69185,"172-166-194-113-176-26-103-114-137-127-89-163-187-153-81-77-141-91-61-36-175-78-142-45-5-177-21-82-111-8-104-138-182-139-168-195-145-15-3-70-13-132-169-188-6-147-115-10-133-122-63-135-38-1-117-131-90-51-121-118-74-134-11-33-160-29-0-109-35-143-106-124-128-62-18-55-34-170-152-140-183-130-95-86-185-22-99-9-199-4-149-28-59-20-60-148-47-94-66-179"
41,47550,100,20891,68441,"28-149-4-140-183-152-170-34-55-18-62-128-124-106-143-35-109-0-29-160-33-11-134-74-118-121-51-90-131-31-117-1-38-135-63-122-133-10-115-147-6-188-169-132-13-70-3-15-145-195-168-139-182-138-104-8-111-82-21-177-5-45-142-78-175-36-61-91-141-77-81-153-187-163-89-127-137-114-103-26-176-113-194-166-22-99-130-95-86-185-179-172-57-66-94-47-148-60-20-59"
42,51743,100,20490,72233,"193-80-190-162-175-78-142-36-61-91-141-97-146-187-165-127-89-103-113-194-166-179-185-130-95-86-183-55-18-62-124-106-176-163-153-81-77-58-82-8-111-144-0-35-109-29-160-33-49-11-134-74-118-121-51-120-191-90-125-131-135-102-63-100-40-107-72-122-133-10-115-147-192-6-188-169-132-13-161-70-3-15-145-195-168-139-182-138-104-21-177-5-45-136-31-164-73-54-117-198"
43,51743,100,20490,72233,"164-73-54-117-198-193-80-190-162-175-78-142-36-61-91-141-97-146-187-165-127-89-103-113-194-166-179-185-130-95-86-183-55-18-62-124-106-176-163-153-81-77-58-82-8-111-144-0-35-109-29-160-33-49-11-134-74-118-121-51-120-191-90-125-131-135-102-63-100-40-107-72-122-133-10-115-147-192-6-188-169-132-13-161-70-3-15-145-195-168-139-182-138-104-21-177-5-45-136-31"
44,51749,100,18657,70406,"29-109-35-0-111-50-81-153-186-163-180-176-64-106-159-143-124-128-62-18-55-34-170-152-4-149-28-59-20-60-94-66-47-148-9-199-140-183-86-95-130-99-22-185-179-172-52-166-194-113-114-137-103-89-127-165-187-146-97-77-141-91-61-36-175-78-142-45-5-177-21-87-82-8-104-56-144-160-33-138-182-11-139-134-43-168-195-13-132-169-6-188-161-70-3-15-145-155-189-69"
45,51898,100,18680,70578,"12-111-50-81-153-186-163-180-176-64-106-159-143-124-128-62-18-55-34-170-152-4-149-28-59-20-60-94-66-47-148-9-199-140-183-86-95-130-99-22-185-179-172-166-194-113-114-137-103-89-127-165-187-146-97-77-141-91-61-36-175-78-142-45-5-177-21-87-82-8-104-56-144-160-33-138-182-11-139-134-43-168-195-13-132-169-6-188-161-70-3-15-145-155-189-69-29-109-35-0"
46,50083,100,17572,67655,"161-188-6-169-132-13-126-168-195-145-15-189-34-55-18-62-128-124-106-159-143-35-109-0-29-160-33-49-11-139-182-138-104-8-56-144-111-82-87-21-177-5-45-142-78-175-36-61-79-91-141-97-77-81-153-146-187-165-163-89-127-137-114-103-26-180-176-113-194-166-86-185-179-52-172-57-66-94-47-148-60-20-59-28-149-4-199-9-99-22-130-95-183-140-152-170-184-155-3-70"
47,48299,100,20657,68956,"176-26-103-114-137-127-89-163-187-153-81-77-141-91-61-36-175-78-142-45-5-177-21-82-111-8-104-138-182-139-168-195-145-15-3-70-13-132-169-188-6-147-115-10-133-122-63-135-38-1-131-90-51-121-118-74-134-11-33-160-29-0-109-35-143-106-124-128-62-18-55-34-170-152-140-183-130-95-86-185-22-99-9-199-4-149-28-59-20-60-148-47-94-66-57-172-179-166-194-113"
48,50083,100,17572,67655,"161-188-6-169-132-13-126-168-195-145-15-189-34-55-18-62-128-124-106-159-143-35-109-0-29-160-33-49-11-139-182-138-104-8-56-144-111-82-87-21-177-5-45-142-78-175-36-61-79-91-141-97-77-81-153-146-187-165-163-89-127-137-114-103-26-180-176-113-194-166-86-185-179-52-172-57-66-94-47-148-60-20-59-28-149-4-199-9-99-22-130-95-183-140-152-170-184-155-3-70"
49,52706,100,19106,71812,"17-107-40-100-63-102-135-122-90-191-125-131-38-27-16-1-156-198-117-193-31-164-73-54-151-19-112-121-116-51-98-118-74-85-134-139-182-138-33-160-144-104-8-82-21-177-5-45-142-78-175-36-61-91-141-77-146-187-165-127-89-103-113-194-166-179-185-130-95-86-124-106-176-163-153-81-111-0-35-109-29-11-43-168-195-13-145-15-3-70-161-132-169-188-6-192-147-178-10-133"
50,51393,100,21239,72632,"137-114-113-194-166-179-172-57-66-94-47-148-60-20-59-28-149-4-199-9-99-22-185-86-95-130-183-140-152-170-34-55-18-62-128-124-143-159-106-64-176-180-26-103-163-186-153-81-111-35-109-0-29-160-33-11-134-74-118-121-51-90-131-31-117-1-38-135-63-122-133-10-115-147-6-188-169-132-13-70-3-15-145-195-168-139-182-138-104-8-21-82-77-141-97-146-187-89-165-127"
51,47995,100,20918,68913,"99-130-95-183-140-152-170-34-55-18-62-128-124-106-143-35-109-0-29-160-33-11-134-74-118-121-51-90-131-117-1-38-135-63-122-133-10-115-147-6-188-169-132-13-70-3-15-145-195-168-139-182-138-104-8-111-82-21-177-5-45-142-78-175-36-61-91-141-77-81-153-187-163-89-127-137-114-103-26-176-113-194-166-86-185-179-172-57-66-94-47-148-60-20-59-28-149-4-199-9"
52,47995,100,20918,68913,"140-152-170-34-55-18-62-128-124-106-143-35-109-0-29-160-33-11-134-74-118-121-51-90-131-117-1-38-135-63-122-133-10-115-147-6-188-169-132-13-70-3-15-145-195-168-139-182-138-104-8-111-82-21-177-5-45-142-78-175-36-61-91-141-77-81-153-187-163-89-127-137-114-103-26-176-113-194-166-86-185-179-172-57-66-94-47-148-60-20-59-28-149-4-199-9-99-130-95-183"
53,52598,100,20266,72864,"91-61-36-141-97-146-187-165-127-89-103-113-194-166-179-185-130-95-86-18-62-124-106-176-163-153-81-77-58-82-8-111-144-0-35-109-29-160-33-49-11-134-74-118-121-51-120-191-90-125-131-112-19-151-54-73-31-193-117-198-156-1-16-27-38-135-63-100-40-107-72-122-133-10-115-147-192-6-188-169-132-13-161-70-3-15-145-195-168-139-182-138-104-21-177-5-45-142-78-175"
54,48054,100,21600,69654,"106-143-86-95-183-140-4-149-28-59-20-60-148-47-94-66-130-99-185-179-172-166-194-176-113-26-103-114-137-127-89-163-187-153-81-77-141-91-61-36-175-78-142-45-5-177-21-82-8-111-144-104-138-182-139-168-195-145-15-3-70-13-132-169-188-6-147-115-10-133-122-63-135-38-1-156-117-193-31-54-131-90-51-121-118-74-134-11-33-160-35-0-29-109-18-55-34-62-128-124"
55,47144,100,21152,68296,"199-183-140-95-130-99-22-179-185-86-166-194-113-176-26-103-114-137-127-89-163-187-153-81-77-141-91-61-36-175-78-142-45-5-177-21-82-111-8-104-138-182-139-168-195-145-15-3-70-13-132-169-188-6-147-115-10-133-122-63-135-38-1-117-193-31-54-131-90-51-121-118-74-134-11-33-160-29-0-109-35-143-106-124-128-62-18-55-34-170-152-4-149-28-20-60-94-66-47-148"
56,51753,100,21460,73213,"186-163-180-176-64-106-159-143-124-128-62-18-55-34-170-152-4-149-28-59-20-60-94-66-47-148-9-199-140-183-86-95-130-99-22-185-179-172-52-166-194-113-26-114-137-103-89-127-165-187-146-97-141-77-82-21-8-104-138-182-139-168-195-145-15-3-70-13-132-169-188-6-147-115-10-133-122-63-135-38-1-117-31-131-90-51-121-118-74-134-11-33-160-29-0-109-35-111-81-153"
57,52598,100,20266,72864,"91-61-36-141-97-146-187-165-127-89-103-113-194-166-179-185-130-95-86-18-62-124-106-176-163-153-81-77-58-82-8-111-144-0-35-109-29-160-33-49-11-134-74-118-121-51-120-191-90-125-131-112-19-151-54-73-31-193-117-198-156-1-16-27-38-135-63-100-40-107-72-122-133-10-115-147-192-6-188-169-132-13-161-70-3-15-145-195-168-139-182-138-104-21-177-5-45-142-78-175"
58,48115,100,21070,69185,"172-166-194-113-176-26-103-114-137-127-89-163-187-153-81-77-141-91-61-36-175-78-142-45-5-177-21-82-111-8-104-138-182-139-168-195-145-15-3-70-13-132-169-188-6-147-115-10-133-122-63-135-38-1-117-131-90-51-121-118-74-134-11-33-160-29-0-109-35-143-106-124-128-62-18-55-34-170-152-140-183-130-95-86-185-22-99-9-199-4-149-28-59-20-60-148-47-94-66-179"
59,51328,100,19765,71093,"116-158-25-182-138-33-160-144-104-8-82-21-177-5-45-142-78-175-36-61-91-141-77-146-187-165-127-89-103-113-194-166-179-185-130-95-86-18-62-124-106-176-163-153-81-111-0-35-109-29-11-139-43-168-195-145-15-3-70-13-132-169-188-6-147-134-74-118-98-51-125-191-90-122-133-10-72-107-40-100-63-102-135-38-27-16-1-156-198-117-193-31-164-73-54-151-19-112-131-121"
60,47550,100,20891,68441,"4-140-183-152-170-34-55-18-62-128-124-106-143-35-109-0-29-160-33-11-134-74-118-121-51-90-131-31-117-1-38-135-63-122-133-10-115-147-6-188-169-132-13-70-3-15-145-195-168-139-182-138-104-8-111-82-21-177-5-45-142-78-175-36-61-91-141-77-81-153-187-163-89-127-137-114-103-26-176-113-194-166-22-99-130-95-86-185-179-172-57-66-94-47-148-60-20-59-28-149"
61,51743,100,20490,72233,"193-80-190-162-175-78-142-36-61-91-141-97-146-187-165-127-89-103-113-194-166-179-185-130-95-86-183-55-18-62-124-106-176-163-153-81-77-58-82-8-111-144-0-35-109-29-160-33-49-11-134-74-118-121-51-120-191-90-125-131-135-102-63-100-40-107-72-122-133-10-115-147-192-6-188-169-132-13-161-70-3-15-145-195-168-139-182-138-104-21-177-5-45-136-31-164-73-54-117-198"
62,51704,100,21475,73179,"163-165-187-146-97-141-77-82-21-8-104-138-182-139-168-195-145-15-3-70-13-132-169-188-6-147-115-10-133-122-63-135-38-1-117-31-131-90-51-121-118-74-134-11-33-160-29-0-109-35-111-81-153-129-180-176-64-106-159-143-124-128-62-18-55-34-170-152-4-149-28-59-20-60-94-66-47-148-9-199-140-183-86-95-130-99-22-185-179-172-52-166-194-113-26-103-114-137-127-89"
63,47922,100,21263,69185,"47-60-20-148-59-28-149-4-140-183-152-170-34-55-18-62-128-124-106-143-35-109-0-29-160-33-11-134-74-118-121-51-90-131-31-117-1-38-135-63-122-133-10-115-147-6-188-169-132-13-70-3-15-145-195-168-139-182-138-104-8-111-82-21-177-5-45-142-78-175-36-61-91-141-77-81-153-187-163-89-127-137-114-103-26-176-113-194-166-22-99-130-95-86-185-179-172-57-66-94"
64,48299,100,20657,68956,"176-26-103-114-137-127-89-163-187-153-81-77-141-91-61-36-175-78-142-45-5-177-21-82-111-8-104-138-182-139-168-195-145-15-3-70-13-132-169-188-6-147-115-10-133-122-63-135-38-1-131-90-51-121-118-74-134-11-33-160-29-0-109-35-143-106-124-128-62-18-55-34-170-152-140-183-130-95-86-185-22-99-9-199-4-149-28-59-20-60-148-47-94-66-57-172-179-166-194-113"
65,51753,100,21460,73213,"141-97-146-187-165-127-89-103-137-114-26-113-194-166-52-172-179-185-22-99-130-95-86-183-140-199-9-148-47-66-94-60-20-59-28-149-4-152-170-34-55-18-62-128-124-143-159-106-64-176-180-163-186-153-81-111-35-109-0-29-160-33-11-134-74-118-121-51-90-131-31-117-1-38-135-63-122-133-10-115-147-6-188-169-132-13-70-3-15-145-195-168-139-182-138-104-8-21-82-77"
66,51461,100,21169,72630,"110-128-106-159-143-124-62-18-55-34-170-152-4-149-28-59-20-60-94-66-47-148-9-199-140-183-95-130-99-22-185-179-172-52-166-194-113-26-103-114-137-127-89-163-165-187-146-97-141-77-82-21-8-104-138-182-139-168-195-145-15-3-70-13-132-169-188-6-147-115-10-133-122-63-135-38-1-117-31-131-90-51-121-118-74-134-11-33-160-29-0-109-35-111-81-153-129-180-176-86"
67,51753,100,21460,73213,"77-82-21-8-104-138-182-139-168-195-145-15-3-70-13-132-169-188-6-147-115-10-133-122-63-135-38-1-117-31-131-90-51-121-118-74-134-11-33-160-29-0-109-35-111-81-153-186-163-180-176-64-106-159-143-124-128-62-18-55-34-170-152-4-149-28-59-20-60-94-66-47-148-9-199-140-183-86-95-130-99-22-185-179-172-52-166-194-113-26-114-137-103-89-127-165-187-146-97-141"
68,52098,100,19917,72015,"46-80-190-193-198-117-54-31-164-73-136-45-5-177-21-104-138-182-139-168-195-145-15-3-70-161-13-132-169-188-6-192-147-115-10-133-122-72-107-40-100-63-102-135-131-125-90-191-120-51-121-118-74-134-11-49-33-160-29-109-35-0-144-111-8-82-58-77-81-153-163-176-106-124-62-18-55-86-95-130-185-179-166-194-113-103-89-127-165-187-146-97-141-91-61-36-142-78-175-162"
69,52253,100,19921,72174,"78-36-61-91-141-97-146-187-165-127-89-103-113-194-166-179-185-130-95-86-18-62-124-106-176-163-153-81-77-58-82-8-111-144-0-35-109-29-160-33-49-11-134-74-118-121-51-120-191-90-125-131-112-19-151-54-73-31-193-117-198-156-1-16-27-38-135-63-100-40-107-72-122-133-10-115-147-192-6-188-169-132-13-161-70-3-15-145-195-168-139-182-138-104-21-177-5-45-142-175"
70,48299,100,20657,68956,"166-194-113-176-26-103-114-137-127-89-163-187-153-81-77-141-91-61-36-175-78-142-45-5-177-21-82-111-8-104-138-182-139-168-195-145-15-3-70-13-132-169-188-6-147-115-10-133-122-63-135-38-1-131-90-51-121-118-74-134-11-33-160-29-0-109-35-143-106-124-128-62-18-55-34-170-152-140-183-130-95-86-185-22-99-9-199-4-149-28-59-20-60-148-47-94-66-57-172-179"
71,51704,100,21475,73179,"127-137-114-103-26-113-194-166-52-172-179-185-22-99-130-95-86-183-140-199-9-148-47-66-94-60-20-59-28-149-4-152-170-34-55-18-62-128-124-143-159-106-64-176-180-129-153-81-111-35-109-0-29-160-33-11-134-74-118-121-51-90-131-31-117-1-38-135-63-122-133-10-115-147-6-188-169-132-13-70-3-15-145-195-168-139-182-138-104-8-21-82-77-141-97-146-187-165-163-89"
72,51917,100,18829,70746,"39-0-35-109-29-69-189-155-145-15-3-70-161-188-6-169-132-13-195-168-43-134-139-11-182-138-104-56-8-82-87-21-177-5-45-142-78-175-36-61-91-141-77-97-146-187-165-127-89-103-137-114-113-194-166-172-179-185-22-99-130-95-86-183-140-199-9-148-47-66-94-60-20-59-28-149-4-152-170-34-55-18-62-128-124-143-159-106-64-176-180-163-186-153-81-41-111-144-33-160"
73,52172,100,20058,72230,"105-136-73-164-31-54-117-198-193-45-5-177-21-104-138-182-139-168-195-145-15-3-70-161-13-132-169-188-6-192-147-115-10-133-122-72-107-40-100-63-102-135-131-125-90-191-120-51-121-118-74-134-11-49-33-160-29-109-35-0-144-111-8-82-58-77-81-153-163-176-106-124-62-18-55-86-95-130-185-179-166-194-113-103-89-127-165-187-146-97-141-91-61-36-142-78-175-162-80-190"
74,48309,100,20472,68781,"53-140-183-95-130-99-9-199-4-149-28-59-20-60-148-47-94-66-57-172-179-185-86-166-194-113-176-26-103-114-137-127-89-163-187-153-81-77-141-91-61-36-175-78-142-45-5-177-21-82-111-8-104-138-182-139-168-195-145-15-3-70-13-132-169-188-6-147-115-10-133-122-63-135-38-1-131-90-51-121-118-74-134-11-33-160-29-0-109-35-143-106-124-128-62-18-55-34-170-152"
75,50172,100,17520,67692,"65-188-6-169-132-13-126-168-195-145-15-189-34-55-18-62-128-124-106-159-143-35-109-0-29-160-33-49-11-139-182-138-104-8-56-144-111-82-87-21-177-5-45-142-78-175-36-61-79-91-141-97-77-81-153-146-187-165-163-89-127-137-114-103-26-180-176-113-194-166-86-185-179-172-57-66-94-47-148-60-20-59-28-149-4-199-9-99-22-130-95-183-140-152-170-184-155-3-70-161"
76,51009,100,17976,68985,"34-83-128-86-176-180-113-194-166-52-172-179-185-22-99-130-95-183-140-199-9-148-47-66-94-60-20-59-28-149-4-152-170-184-155-189-3-70-15-145-13-132-169-188-6-126-195-168-43-139-11-182-138-33-160-144-56-104-8-82-87-21-177-5-45-142-78-175-36-61-79-91-141-77-97-146-187-165-137-114-127-89-103-163-186-153-81-50-111-109-29-0-35-143-159-106-124-62-18-55"
77,52137,100,19212,71349,"191-71-147-192-6-188-169-132-161-70-3-15-145-13-195-168-43-11-29-109-35-0-111-81-153-163-176-106-124-62-86-95-130-185-179-166-194-113-103-89-127-165-187-146-77-141-91-61-36-175-78-142-45-5-177-21-82-8-104-144-160-33-138-182-139-134-85-74-118-98-51-116-121-131-112-19-151-54-73-164-31-193-117-198-156-1-16-27-38-135-102-63-100-40-107-72-10-133-122-90"
78,52172,100,20058,72230,"105-136-73-164-31-54-117-198-193-45-5-177-21-104-138-182-139-168-195-145-15-3-70-161-13-132-169-188-6-192-147-115-10-133-122-72-107-40-100-63-102-135-131-125-90-191-120-51-121-118-74-134-11-49-33-160-29-109-35-0-144-111-8-82-58-77-81-153-163-176-106-124-62-18-55-86-95-130-185-179-166-194-113-103-89-127-165-187-146-97-141-91-61-36-142-78-175-162-80-190"
79,48299,100,20657,68956,"179-166-194-113-176-26-103-114-137-127-89-163-187-153-81-77-141-91-61-36-175-78-142-45-5-177-21-82-111-8-104-138-182-139-168-195-145-15-3-70-13-132-169-188-6-147-115-10-133-122-63-135-38-1-131-90-51-121-118-74-134-11-33-160-29-0-109-35-143-106-124-128-62-18-55-34-170-152-140-183-130-95-86-185-22-99-9-199-4-149-28-59-20-60-148-47-94-66-57-172"
80,51237,100,21147,72384,"128-106-159-143-124-62-18-55-34-170-152-140-183-95-130-22-99-9-199-4-149-28-59-20-60-148-47-94-66-57-172-179-185-86-166-194-113-26-103-114-137-127-89-163-165-187-146-97-141-77-82-21-8-104-138-182-139-168-195-145-15-3-70-13-132-169-188-6-147-115-10-133-122-63-135-38-1-117-31-131-90-51-121-118-74-134-11-33-160-29-0-109-35-111-81-153-129-180-176-64"
81,53956,100,19040,72996,"16-27-38-92-102-63-96-32-135-122-133-10-178-115-147-71-191-90-51-125-131-121-112-19-151-54-73-164-31-136-45-5-177-21-104-138-182-139-168-195-145-15-3-70-161-13-132-169-188-6-134-11-49-33-160-29-109-35-0-144-111-8-82-58-77-81-153-163-176-86-95-130-185-179-166-194-113-103-89-127-165-187-146-97-141-91-61-36-142-78-175-162-80-190-193-117-198-156-24-1"
82,47199,100,21075,68274,"20-60-94-66-47-148-99-22-179-185-86-95-130-166-194-113-176-26-103-114-137-127-89-163-187-153-81-77-141-91-61-36-175-78-142-45-5-177-21-82-111-8-104-138-182-139-168-195-145-15-3-70-13-132-169-188-6-147-115-10-133-122-63-135-38-1-117-193-31-54-131-90-51-121-118-74-134-11-33-160-29-0-109-35-143-106-124-128-62-18-55-34-170-152-183-140-4-149-28-59"
83,53956,100,19040,72996,"16-27-38-92-102-63-96-32-135-122-133-10-178-115-147-71-191-90-51-125-131-121-112-19-151-54-73-164-31-136-45-5-177-21-104-138-182-139-168-195-145-15-3-70-161-13-132-169-188-6-134-11-49-33-160-29-109-35-0-144-111-8-82-58-77-81-153-163-176-86-95-130-185-179-166-194-113-103-89-127-165-187-146-97-141-91-61-36-142-78-175-162-80-190-193-117-198-156-24-1"
84,51009,100,17976,68985,"18-55-34-83-128-86-176-180-113-194-166-52-172-179-185-22-99-130-95-183-140-199-9-148-47-66-94-60-20-59-28-149-4-152-170-184-155-189-3-70-15-145-13-132-169-188-6-126-195-168-43-139-11-182-138-33-160-144-56-104-8-82-87-21-177-5-45-142-78-175-36-61-79-91-141-77-97-146-187-165-137-114-127-89-103-163-186-153-81-50-111-109-29-0-35-143-159-106-124-62"
85,51009,100,17976,68985,"34-83-128-86-176-180-113-194-166-52-172-179-185-22-99-130-95-183-140-199-9-148-47-66-94-60-20-59-28-149-4-152-170-184-155-189-3-70-15-145-13-132-169-188-6-126-195-168-43-139-11-182-138-33-160-144-56-104-8-82-87-21-177-5-45-142-78-175-36-61-79-91-141-77-97-146-187-165-137-114-127-89-103-163-186-153-81-50-111-109-29-0-35-143-159-106-124-62-18-55"
86,51328,100,19765,71093,"116-158-25-182-138-33-160-144-104-8-82-21-177-5-45-142-78-175-36-61-91-141-77-146-187-165-127-89-103-113-194-166-179-185-130-95-86-18-62-124-106-176-163-153-81-111-0-35-109-29-11-139-43-168-195-145-15-3-70-13-132-169-188-6-147-134-74-118-98-51-125-191-90-122-133-10-72-107-40-100-63-102-135-38-27-16-1-156-198-117-193-31-164-73-54-151-19-112-131-121"
87,51743,100,20490,72233,"31-164-73-54-117-198-193-80-190-162-175-78-142-36-61-91-141-97-146-187-165-127-89-103-113-194-166-179-185-130-95-86-183-55-18-62-124-106-176-163-153-81-77-58-82-8-111-144-0-35-109-29-160-33-49-11-134-74-118-121-51-120-191-90-125-131-135-102-63-100-40-107-72-122-133-10-115-147-192-6-188-169-132-13-161-70-3-15-145-195-168-139-182-138-104-21-177-5-45-136"
88,49288,100,20242,69530,"2-139-11-182-138-33-160-144-104-8-82-21-177-5-45-142-78-175-36-61-91-141-77-97-146-187-165-127-89-103-113-194-166-179-185-22-99-130-95-86-183-140-152-170-34-55-18-62-124-106-176-163-153-81-111-0-35-109-29-168-195-145-15-3-70-13-132-169-188-6-147-115-10-133-122-72-107-40-100-63-135-38-27-16-1-156-198-117-193-31-54-151-131-90-191-51-121-118-74-134"
89,48054,100,21600,69654,"124-128-62-34-55-18-109-29-0-35-160-33-11-134-74-118-121-51-90-131-54-31-193-117-156-1-38-135-63-122-133-10-115-147-6-188-169-132-13-70-3-15-145-195-168-139-182-138-104-144-111-8-82-21-177-5-45-142-78-175-36-61-91-141-77-81-153-187-163-89-127-137-114-103-26-113-176-194-166-172-179-185-99-130-66-94-47-148-60-20-59-28-149-4-140-183-95-86-143-106"
90,48299,100,20657,68956,"176-26-103-114-137-127-89-163-187-153-81-77-141-91-61-36-175-78-142-45-5-177-21-82-111-8-104-138-182-139-168-195-145-15-3-70-13-132-169-188-6-147-115-10-133-122-63-135-38-1-131-90-51-121-118-74-134-11-33-160-29-0-109-35-143-106-124-128-62-18-55-34-170-152-140-183-130-95-86-185-22-99-9-199-4-149-28-59-20-60-148-47-94-66-57-172-179-166-194-113"
91,52048,100,20554,72602,"50-81-153-163-180-176-64-106-143-124-128-62-18-55-34-170-152-140-183-86-95-130-99-22-185-179-172-166-194-113-114-137-103-89-127-165-187-146-97-141-77-82-21-8-104-138-182-139-168-195-145-15-3-70-13-132-169-188-6-192-147-115-10-133-122-72-107-40-100-63-135-38-27-16-1-156-198-117-193-31-73-54-151-19-131-90-191-51-121-118-74-134-11-33-160-29-0-109-35-111"
92,51749,100,18657,70406,"35-109-29-69-189-155-145-15-3-70-161-188-6-169-132-13-195-168-43-134-139-11-182-138-33-160-144-56-104-8-82-87-21-177-5-45-142-78-175-36-61-91-141-77-97-146-187-165-127-89-103-137-114-113-194-166-52-172-179-185-22-99-130-95-86-183-140-199-9-148-47-66-94-60-20-59-28-149-4-152-170-34-55-18-62-128-124-143-159-106-64-176-180-163-186-153-81-50-111-0"
93,51749,100,18657,70406,"35-109-29-69-189-155-145-15-3-70-161-188-6-169-132-13-195-168-43-134-139-11-182-138-33-160-144-56-104-8-82-87-21-177-5-45-142-78-175-36-61-91-141-77-97-146-187-165-127-89-103-137-114-113-194-166-52-172-179-185-22-99-130-95-86-183-140-199-9-148-47-66-94-60-20-59-28-149-4-152-170-34-55-18-62-128-124-143-159-106-64-176-180-163-186-153-81-50-111-0"
94,51567,100,21182,72749,"64-86-95-128-106-159-143-124-62-18-55-34-170-152-174-183-140-199-4-149-28-59-20-60-148-47-94-66-22-130-99-185-179-172-52-166-194-113-26-103-114-137-127-89-163-165-187-146-97-141-77-82-21-8-104-138-182-139-168-195-145-15-3-70-13-132-169-188-6-147-115-10-133-122-63-135-38-1-117-31-131-90-51-121-118-74-134-11-33-160-29-0-109-35-111-81-153-129-180-176"
95,51681,100,20428,72109,"117-54-73-164-31-136-45-5-177-21-104-138-182-139-168-195-145-15-3-70-161-13-132-169-188-6-192-147-115-10-133-122-72-107-40-100-63-102-135-131-125-90-191-120-51-121-118-74-134-11-49-33-160-29-109-35-0-144-111-8-82-58-77-81-153-163-176-106-124-62-18-55-183-86-95-130-185-179-166-194-113-103-89-127-165-187-146-97-141-91-61-36-142-78-175-162-80-190-193-198"
96,54018,100,19102,73120,"19-112-121-131-125-51-90-191-71-147-115-178-10-133-122-135-32-96-63-102-92-38-27-16-1-24-156-198-117-193-80-190-162-175-78-142-36-61-91-141-97-146-187-165-127-89-103-113-194-166-179-185-130-95-86-176-163-153-81-77-58-82-8-111-144-0-35-109-29-160-33-49-11-134-6-188-169-132-13-161-70-3-15-145-195-168-139-182-138-104-21-177-5-45-136-31-164-73-54-151"
97,52706,100,19106,71812,"17-107-40-100-63-102-135-122-90-191-125-131-38-27-16-1-156-198-117-193-31-164-73-54-151-19-112-121-116-51-98-118-74-85-134-139-182-138-33-160-144-104-8-82-21-177-5-45-142-78-175-36-61-91-141-77-146-187-165-127-89-103-113-194-166-179-185-130-95-86-124-106-176-163-153-81-111-0-35-109-29-11-43-168-195-13-145-15-3-70-161-132-169-188-6-192-147-178-10-133"
98,50083,100,17572,67655,"155-184-170-152-140-183-95-130-22-99-9-199-4-149-28-59-20-60-148-47-94-66-57-172-52-179-185-86-166-194-113-176-180-26-103-114-137-127-89-163-165-187-146-153-81-77-97-141-91-79-61-36-175-78-142-45-5-177-21-87-82-111-144-56-8-104-138-182-139-11-49-33-160-29-0-109-35-143-159-106-124-128-62-18-55-34-189-15-145-195-168-126-13-132-169-6-188-161-70-3"
99,48054,100,21600,69654,"124-128-62-34-55-18-109-29-0-35-160-33-11-134-74-118-121-51-90-131-54-31-193-117-156-1-38-135-63-122-133-10-115-147-6-188-169-132-13-70-3-15-145-195-168-139-182-138-104-144-111-8-82-21-177-5-45-142-78-175-36-61-91-141-77-81-153-187-163-89-127-137-114-103-26-113-176-194-166-172-179-185-99-130-66-94-47-148-60-20-59-28-149-4-140-183-95-86-143-106"
100,53794,100,20314,74108,"25-5-45-142-78-175-7-36-61-91-141-97-146-187-165-127-89-103-113-194-166-179-185-130-95-86-124-106-176-163-153-81-77-58-82-8-111-144-0-35-109-29-160-33-49-11-134-74-118-121-51-120-191-90-125-131-112-19-151-54-73-31-193-117-198-156-1-16-27-38-135-63-100-40-107-72-122-133-10-115-147-192-6-188-169-132-13-161-70-3-15-145-195-168-139-182-138-104-21-177"
